"","FaceID","ID","FirstRating","GroupRating","SecondRating","Change","Feedback","Condition"
"1",10,"17",7,5,5,-2,-2,"Peri"
"2",10,"1879",6,6,4,-2,0,"Peri"
"3",10,"1918",7,4,4,-3,-3,"Peri"
"4",10,"2205",8,6,7,-1,-2,"Peri"
"5",10,"4520",7,5,7,0,-2,"Peri"
"6",10,"45bites",5,2,2,-3,-3,"Peri"
"7",10,"6107",6,3,5,-1,-3,"Peri"
"8",10,"9696",6,4,5,-1,-2,"Peri"
"9",10,"andrea",5,7,5,0,2,"Peri"
"10",10,"Asad",6,6,2,-4,0,"Peri"
"11",10,"ASDF1234",5,8,4,-1,3,"Peri"
"12",10,"Astrid",6,8,6,0,2,"Peri"
"13",10,"Bøllemis",7,7,7,0,0,"Peri"
"14",10,"Carmesin",4,6,5,1,2,"Peri"
"15",10,"Christian Jacobsen",6,3,5,-1,-3,"Peri"
"16",10,"GOAT",5,2,4,-1,-3,"Peri"
"17",10,"Grandmasterflash",7,7,7,0,0,"Peri"
"18",10,"havegang7",6,6,7,1,0,"Peri"
"19",10,"hejhejhund",6,8,7,1,2,"Peri"
"20",10,"Jesper",3,6,2,-1,3,"Peri"
"21",10,"Johanne",7,4,7,0,-3,"Peri"
"22",10,"Katrine",6,3,6,0,-3,"Peri"
"23",10,"lilla",5,2,4,-1,-3,"Peri"
"24",10,"Llamaman",5,7,8,3,2,"Peri"
"25",10,"minime",6,8,7,1,2,"Peri"
"26",10,"Misterperc",4,4,5,1,0,"Peri"
"27",10,"Moe",7,7,6,-1,0,"Peri"
"28",10,"Python",5,8,5,0,3,"Peri"
"29",10,"RBJ",5,5,5,0,0,"Peri"
"30",10,"Rensdyrlam",7,4,8,1,-3,"Peri"
"31",10,"rosenmeier",3,1,4,1,-2,"Peri"
"32",10,"Sarah",7,0,5,-2,NA,"Peri"
"33",10,"SKJ",8,6,6,-2,-2,"Peri"
"34",10,"Slowlydying",1,3,7,6,2,"Peri"
"35",10,"SOJ",4,6,5,1,2,"Peri"
"36",10,"wtf",4,6,5,1,2,"Peri"
"37",11,"17",6,3,5,-1,-3,"Peri"
"38",11,"1879",4,6,5,1,2,"Peri"
"39",11,"1918",7,5,4,-3,-2,"Peri"
"40",11,"2205",7,4,7,0,-3,"Peri"
"41",11,"4520",4,0,6,2,NA,"Peri"
"42",11,"45bites",8,8,6,-2,0,"Peri"
"43",11,"6107",5,2,5,0,-3,"Peri"
"44",11,"9696",6,8,5,-1,2,"Peri"
"45",11,"andrea",5,3,7,2,-2,"Peri"
"46",11,"Asad",5,7,5,0,2,"Peri"
"47",11,"ASDF1234",6,3,6,0,-3,"Peri"
"48",11,"Astrid",8,8,7,-1,0,"Peri"
"49",11,"Bøllemis",7,0,7,0,NA,"Peri"
"50",11,"Carmesin",4,0,5,1,NA,"Peri"
"51",11,"Christian Jacobsen",6,3,3,-3,-3,"Peri"
"52",11,"GOAT",5,5,4,-1,0,"Peri"
"53",11,"Grandmasterflash",5,7,5,0,2,"Peri"
"54",11,"havegang7",7,5,6,-1,-2,"Peri"
"55",11,"hejhejhund",3,0,5,2,NA,"Peri"
"56",11,"JakobBjerreKnudsen",6,6,4,-2,0,"Peri"
"57",11,"Jesper",4,1,5,1,-3,"Peri"
"58",11,"Johanne",6,4,8,2,-2,"Peri"
"59",11,"Katrine",6,3,6,0,-3,"Peri"
"60",11,"lilla",8,8,8,0,0,"Peri"
"61",11,"Llamaman",3,3,7,4,0,"Peri"
"62",11,"minime",6,3,7,1,-3,"Peri"
"63",11,"Misterperc",5,8,4,-1,3,"Peri"
"64",11,"Moe",5,0,7,2,NA,"Peri"
"65",11,"Python",7,4,6,-1,-3,"Peri"
"66",11,"RBJ",2,5,7,5,3,"Peri"
"67",11,"Rensdyrlam",8,8,4,-4,0,"Peri"
"68",11,"rosenmeier",6,3,6,0,-3,"Peri"
"69",11,"Sarah",7,7,6,-1,0,"Peri"
"70",11,"SKJ",2,5,3,1,3,"Peri"
"71",11,"Slowlydying",7,0,8,1,NA,"Peri"
"72",11,"SOJ",2,2,3,1,0,"Peri"
"73",11,"The cat",8,6,8,0,-2,"Peri"
"74",11,"wtf",5,8,5,0,3,"Peri"
"75",12,"17",3,6,3,0,3,"Peri"
"76",12,"1879",5,0,6,1,NA,"Peri"
"77",12,"1918",5,3,5,0,-2,"Peri"
"78",12,"2205",3,3,4,1,0,"Peri"
"79",12,"4520",2,0,3,1,NA,"Peri"
"80",12,"45bites",4,1,3,-1,-3,"Peri"
"81",12,"6107",4,1,3,-1,-3,"Peri"
"82",12,"9696",4,7,2,-2,3,"Peri"
"83",12,"andrea",6,8,6,0,2,"Peri"
"84",12,"Asad",4,0,3,-1,NA,"Peri"
"85",12,"ASDF1234",5,7,4,-1,2,"Peri"
"86",12,"Astrid",6,0,5,-1,NA,"Peri"
"87",12,"Bøllemis",7,5,7,0,-2,"Peri"
"88",12,"Carmesin",5,2,4,-1,-3,"Peri"
"89",12,"Christian Jacobsen",6,8,6,0,2,"Peri"
"90",12,"GOAT",3,3,3,0,0,"Peri"
"91",12,"Grandmasterflash",4,6,5,1,2,"Peri"
"92",12,"havegang7",6,8,6,0,2,"Peri"
"93",12,"hejhejhund",4,6,3,-1,2,"Peri"
"94",12,"Jesper",2,5,3,1,3,"Peri"
"95",12,"Johanne",6,8,7,1,2,"Peri"
"96",12,"Katrine",6,8,6,0,2,"Peri"
"97",12,"lilla",6,0,5,-1,NA,"Peri"
"98",12,"Llamaman",5,5,4,-1,0,"Peri"
"99",12,"minime",3,0,5,2,NA,"Peri"
"100",12,"Misterperc",2,5,3,1,3,"Peri"
"101",12,"Moe",3,1,4,1,-2,"Peri"
"102",12,"Python",3,6,2,-1,3,"Peri"
"103",12,"RBJ",1,0,6,5,NA,"Peri"
"104",12,"Rensdyrlam",3,3,3,0,0,"Peri"
"105",12,"rosenmeier",2,4,4,2,2,"Peri"
"106",12,"Sarah",4,6,5,1,2,"Peri"
"107",12,"SKJ",3,3,4,1,0,"Peri"
"108",12,"Slowlydying",8,5,5,-3,-3,"Peri"
"109",12,"SOJ",6,4,3,-3,-2,"Peri"
"110",12,"The cat",8,5,8,0,-3,"Peri"
"111",12,"wtf",4,0,4,0,NA,"Peri"
"112",13,"17",5,3,4,-1,-2,"Peri"
"113",13,"1879",3,6,2,-1,3,"Peri"
"114",13,"1918",4,6,4,0,2,"Peri"
"115",13,"2205",4,4,4,0,0,"Peri"
"116",13,"4520",3,3,3,0,0,"Peri"
"117",13,"45bites",5,7,4,-1,2,"Peri"
"118",13,"6107",2,2,2,0,0,"Peri"
"119",13,"9696",2,2,2,0,0,"Peri"
"120",13,"andrea",6,4,2,-4,-2,"Peri"
"121",13,"Asad",5,5,3,-2,0,"Peri"
"122",13,"ASDF1234",3,5,3,0,2,"Peri"
"123",13,"Astrid",2,5,4,2,3,"Peri"
"124",13,"Bøllemis",7,5,7,0,-2,"Peri"
"125",13,"Carmesin",4,2,4,0,-2,"Peri"
"126",13,"Christian Jacobsen",3,1,3,0,-2,"Peri"
"127",13,"GOAT",2,5,2,0,3,"Peri"
"128",13,"Grandmasterflash",6,3,4,-2,-3,"Peri"
"129",13,"havegang7",5,3,6,1,-2,"Peri"
"130",13,"hejhejhund",3,1,3,0,-2,"Peri"
"131",13,"JakobBjerreKnudsen",4,0,5,1,NA,"Peri"
"132",13,"Jesper",6,4,1,-5,-2,"Peri"
"133",13,"Johanne",6,3,5,-1,-3,"Peri"
"134",13,"Katrine",5,3,5,0,-2,"Peri"
"135",13,"lilla",5,7,4,-1,2,"Peri"
"136",13,"Llamaman",2,2,2,0,0,"Peri"
"137",13,"minime",1,0,4,3,NA,"Peri"
"138",13,"Misterperc",7,5,6,-1,-2,"Peri"
"139",13,"Moe",3,5,4,1,2,"Peri"
"140",13,"Python",4,7,2,-2,3,"Peri"
"141",13,"RBJ",1,1,5,4,0,"Peri"
"142",13,"Rensdyrlam",2,2,2,0,0,"Peri"
"143",13,"rosenmeier",2,0,3,1,NA,"Peri"
"144",13,"Sarah",3,1,6,3,-2,"Peri"
"145",13,"SKJ",2,5,4,2,3,"Peri"
"146",13,"Slowlydying",3,1,4,1,-2,"Peri"
"147",13,"SOJ",1,4,2,1,3,"Peri"
"148",13,"wtf",2,0,2,0,NA,"Peri"
"149",14,"17",6,4,2,-4,-2,"Peri"
"150",14,"1879",7,0,5,-2,NA,"Peri"
"151",14,"1918",4,0,5,1,NA,"Peri"
"152",14,"2205",1,0,2,1,NA,"Peri"
"153",14,"4520",3,6,2,-1,3,"Peri"
"154",14,"45bites",2,5,4,2,3,"Peri"
"155",14,"6107",5,7,5,0,2,"Peri"
"156",14,"9696",1,4,3,2,3,"Peri"
"157",14,"andrea",5,7,5,0,2,"Peri"
"158",14,"Asad",6,8,2,-4,2,"Peri"
"159",14,"ASDF1234",5,8,5,0,3,"Peri"
"160",14,"Astrid",1,3,2,1,2,"Peri"
"161",14,"Bøllemis",7,5,7,0,-2,"Peri"
"162",14,"Carmesin",3,1,3,0,-2,"Peri"
"163",14,"Christian Jacobsen",2,5,3,1,3,"Peri"
"164",14,"GOAT",6,3,3,-3,-3,"Peri"
"165",14,"Grandmasterflash",6,8,5,-1,2,"Peri"
"166",14,"havegang7",5,7,7,2,2,"Peri"
"167",14,"hejhejhund",5,3,3,-2,-2,"Peri"
"168",14,"Jesper",5,7,4,-1,2,"Peri"
"169",14,"Johanne",5,0,7,2,NA,"Peri"
"170",14,"Katrine",5,7,5,0,2,"Peri"
"171",14,"lilla",3,6,4,1,3,"Peri"
"172",14,"Llamaman",3,0,2,-1,NA,"Peri"
"173",14,"minime",7,7,4,-3,0,"Peri"
"174",14,"Misterperc",5,2,3,-2,-3,"Peri"
"175",14,"Moe",3,1,7,4,-2,"Peri"
"176",14,"Python",3,3,4,1,0,"Peri"
"177",14,"RBJ",2,4,6,4,2,"Peri"
"178",14,"Rensdyrlam",3,3,1,-2,0,"Peri"
"179",14,"rosenmeier",2,5,3,1,3,"Peri"
"180",14,"Sarah",7,4,4,-3,-3,"Peri"
"181",14,"SKJ",5,2,5,0,-3,"Peri"
"182",14,"Slowlydying",7,0,8,1,NA,"Peri"
"183",14,"SOJ",2,2,4,2,0,"Peri"
"184",14,"wtf",3,6,4,1,3,"Peri"
"185",15,"17",6,3,4,-2,-3,"Peri"
"186",15,"1879",4,6,5,1,2,"Peri"
"187",15,"1918",6,3,1,-5,-3,"Peri"
"188",15,"2205",6,0,5,-1,NA,"Peri"
"189",15,"4520",6,6,6,0,0,"Peri"
"190",15,"45bites",3,1,3,0,-2,"Peri"
"191",15,"6107",5,2,5,0,-3,"Peri"
"192",15,"9696",4,6,4,0,2,"Peri"
"193",15,"andrea",6,3,5,-1,-3,"Peri"
"194",15,"Asad",4,7,1,-3,3,"Peri"
"195",15,"ASDF1234",5,8,4,-1,3,"Peri"
"196",15,"Astrid",4,6,2,-2,2,"Peri"
"197",15,"Bøllemis",7,4,7,0,-3,"Peri"
"198",15,"Carmesin",4,4,5,1,0,"Peri"
"199",15,"Christian Jacobsen",5,8,4,-1,3,"Peri"
"200",15,"GOAT",3,6,4,1,3,"Peri"
"201",15,"Grandmasterflash",5,0,4,-1,NA,"Peri"
"202",15,"havegang7",5,0,6,1,NA,"Peri"
"203",15,"hejhejhund",6,6,4,-2,0,"Peri"
"204",15,"JakobBjerreKnudsen",4,0,5,1,NA,"Peri"
"205",15,"Jesper",2,2,2,0,0,"Peri"
"206",15,"Johanne",6,6,5,-1,0,"Peri"
"207",15,"Katrine",5,0,6,1,NA,"Peri"
"208",15,"lilla",5,2,4,-1,-3,"Peri"
"209",15,"Llamaman",4,2,5,1,-2,"Peri"
"210",15,"minime",7,5,5,-2,-2,"Peri"
"211",15,"Misterperc",3,1,3,0,-2,"Peri"
"212",15,"Moe",3,3,7,4,0,"Peri"
"213",15,"Python",6,3,6,0,-3,"Peri"
"214",15,"RBJ",1,3,6,5,2,"Peri"
"215",15,"Rensdyrlam",3,0,2,-1,NA,"Peri"
"216",15,"rosenmeier",4,7,4,0,3,"Peri"
"217",15,"Sarah",7,5,5,-2,-2,"Peri"
"218",15,"SKJ",6,4,6,0,-2,"Peri"
"219",15,"Slowlydying",8,8,8,0,0,"Peri"
"220",15,"SOJ",4,2,2,-2,-2,"Peri"
"221",15,"wtf",3,6,3,0,3,"Peri"
"222",16,"17",5,8,4,-1,3,"Peri"
"223",16,"1879",4,7,5,1,3,"Peri"
"224",16,"1918",3,6,5,2,3,"Peri"
"225",16,"2205",7,4,4,-3,-3,"Peri"
"226",16,"4520",2,4,4,2,2,"Peri"
"227",16,"45bites",5,7,5,0,2,"Peri"
"228",16,"6107",5,2,5,0,-3,"Peri"
"229",16,"9696",3,6,3,0,3,"Peri"
"230",16,"andrea",5,7,7,2,2,"Peri"
"231",16,"Asad",2,5,2,0,3,"Peri"
"232",16,"ASDF1234",4,6,4,0,2,"Peri"
"233",16,"Astrid",3,5,6,3,2,"Peri"
"234",16,"Bøllemis",7,4,7,0,-3,"Peri"
"235",16,"Carmesin",2,4,4,2,2,"Peri"
"236",16,"Christian Jacobsen",5,3,5,0,-2,"Peri"
"237",16,"GOAT",6,6,3,-3,0,"Peri"
"238",16,"Grandmasterflash",4,6,4,0,2,"Peri"
"239",16,"havegang7",6,0,6,0,NA,"Peri"
"240",16,"hejhejhund",3,6,4,1,3,"Peri"
"241",16,"JakobBjerreKnudsen",6,4,5,-1,-2,"Peri"
"242",16,"Jesper",4,4,1,-3,0,"Peri"
"243",16,"Johanne",6,6,6,0,0,"Peri"
"244",16,"Katrine",6,6,6,0,0,"Peri"
"245",16,"lilla",3,1,4,1,-2,"Peri"
"246",16,"Llamaman",3,0,3,0,NA,"Peri"
"247",16,"minime",4,6,5,1,2,"Peri"
"248",16,"Misterperc",4,2,3,-1,-2,"Peri"
"249",16,"Moe",2,2,6,4,0,"Peri"
"250",16,"Python",5,3,4,-1,-2,"Peri"
"251",16,"RBJ",2,2,5,3,0,"Peri"
"252",16,"Rensdyrlam",4,4,4,0,0,"Peri"
"253",16,"rosenmeier",4,1,4,0,-3,"Peri"
"254",16,"Sarah",6,3,6,0,-3,"Peri"
"255",16,"SKJ",4,1,3,-1,-3,"Peri"
"256",16,"Slowlydying",5,7,6,1,2,"Peri"
"257",16,"SOJ",2,0,2,0,NA,"Peri"
"258",16,"The cat",8,8,8,0,0,"Peri"
"259",16,"wtf",1,1,3,2,0,"Peri"
"260",17,"17",6,4,3,-3,-2,"Peri"
"261",17,"1879",3,1,3,0,-2,"Peri"
"262",17,"1918",4,1,6,2,-3,"Peri"
"263",17,"2205",6,6,6,0,0,"Peri"
"264",17,"4520",5,3,6,1,-2,"Peri"
"265",17,"45bites",2,4,2,0,2,"Peri"
"266",17,"6107",4,6,6,2,2,"Peri"
"267",17,"9696",6,3,5,-1,-3,"Peri"
"268",17,"andrea",7,7,3,-4,0,"Peri"
"269",17,"Asad",1,1,1,0,0,"Peri"
"270",17,"ASDF1234",4,4,5,1,0,"Peri"
"271",17,"Astrid",8,5,6,-2,-3,"Peri"
"272",17,"Bøllemis",7,7,7,0,0,"Peri"
"273",17,"Carmesin",4,2,4,0,-2,"Peri"
"274",17,"Christian Jacobsen",7,7,6,-1,0,"Peri"
"275",17,"GOAT",3,0,3,0,NA,"Peri"
"276",17,"Grandmasterflash",6,3,5,-1,-3,"Peri"
"277",17,"havegang7",7,7,8,1,0,"Peri"
"278",17,"hejhejhund",4,2,3,-1,-2,"Peri"
"279",17,"JakobBjerreKnudsen",5,2,5,0,-3,"Peri"
"280",17,"Jesper",2,5,2,0,3,"Peri"
"281",17,"Johanne",8,5,7,-1,-3,"Peri"
"282",17,"Katrine",6,6,6,0,0,"Peri"
"283",17,"lilla",8,5,7,-1,-3,"Peri"
"284",17,"Llamaman",7,4,6,-1,-3,"Peri"
"285",17,"minime",2,2,6,4,0,"Peri"
"286",17,"Misterperc",3,0,3,0,NA,"Peri"
"287",17,"Moe",3,0,6,3,NA,"Peri"
"288",17,"Python",5,0,5,0,NA,"Peri"
"289",17,"RBJ",2,2,6,4,0,"Peri"
"290",17,"Rensdyrlam",7,4,2,-5,-3,"Peri"
"291",17,"rosenmeier",3,1,2,-1,-2,"Peri"
"292",17,"Sarah",7,4,6,-1,-3,"Peri"
"293",17,"SKJ",7,4,6,-1,-3,"Peri"
"294",17,"Slowlydying",8,8,7,-1,0,"Peri"
"295",17,"SOJ",5,0,4,-1,NA,"Peri"
"296",17,"The cat",8,5,8,0,-3,"Peri"
"297",17,"wtf",7,5,7,0,-2,"Peri"
"298",18,"17",5,8,6,1,3,"Peri"
"299",18,"1879",4,4,3,-1,0,"Peri"
"300",18,"1918",5,8,1,-4,3,"Peri"
"301",18,"2205",6,0,5,-1,NA,"Peri"
"302",18,"4520",5,5,5,0,0,"Peri"
"303",18,"45bites",7,5,7,0,-2,"Peri"
"304",18,"6107",6,4,6,0,-2,"Peri"
"305",18,"9696",7,4,6,-1,-3,"Peri"
"306",18,"andrea",7,5,5,-2,-2,"Peri"
"307",18,"Asad",5,7,4,-1,2,"Peri"
"308",18,"ASDF1234",5,2,6,1,-3,"Peri"
"309",18,"Astrid",8,6,3,-5,-2,"Peri"
"310",18,"Bøllemis",7,5,7,0,-2,"Peri"
"311",18,"Carmesin",4,2,6,2,-2,"Peri"
"312",18,"Christian Jacobsen",6,8,6,0,2,"Peri"
"313",18,"GOAT",5,5,4,-1,0,"Peri"
"314",18,"Grandmasterflash",4,2,3,-1,-2,"Peri"
"315",18,"havegang7",8,8,8,0,0,"Peri"
"316",18,"hejhejhund",6,4,6,0,-2,"Peri"
"317",18,"JakobBjerreKnudsen",7,4,6,-1,-3,"Peri"
"318",18,"Jesper",1,1,1,0,0,"Peri"
"319",18,"Johanne",7,4,6,-1,-3,"Peri"
"320",18,"Katrine",5,7,6,1,2,"Peri"
"321",18,"lilla",6,3,5,-1,-3,"Peri"
"322",18,"Llamaman",8,6,8,0,-2,"Peri"
"323",18,"minime",1,1,5,4,0,"Peri"
"324",18,"Misterperc",6,3,5,-1,-3,"Peri"
"325",18,"Moe",4,6,7,3,2,"Peri"
"326",18,"Python",4,6,3,-1,2,"Peri"
"327",18,"RBJ",2,5,7,5,3,"Peri"
"328",18,"Rensdyrlam",8,0,8,0,NA,"Peri"
"329",18,"rosenmeier",5,8,5,0,3,"Peri"
"330",18,"Sarah",7,0,8,1,NA,"Peri"
"331",18,"SKJ",5,3,7,2,-2,"Peri"
"332",18,"Slowlydying",8,6,6,-2,-2,"Peri"
"333",18,"SOJ",2,2,3,1,0,"Peri"
"334",18,"wtf",2,4,5,3,2,"Peri"
"335",19,"17",5,7,5,0,2,"Peri"
"336",19,"1879",3,1,3,0,-2,"Peri"
"337",19,"1918",7,5,2,-5,-2,"Peri"
"338",19,"2205",6,4,6,0,-2,"Peri"
"339",19,"4520",7,5,7,0,-2,"Peri"
"340",19,"45bites",4,6,4,0,2,"Peri"
"341",19,"6107",6,8,7,1,2,"Peri"
"342",19,"9696",4,1,5,1,-3,"Peri"
"343",19,"andrea",6,8,6,0,2,"Peri"
"344",19,"Asad",4,6,5,1,2,"Peri"
"345",19,"ASDF1234",6,3,5,-1,-3,"Peri"
"346",19,"Astrid",6,4,6,0,-2,"Peri"
"347",19,"Bøllemis",7,5,7,0,-2,"Peri"
"348",19,"Carmesin",4,6,5,1,2,"Peri"
"349",19,"Christian Jacobsen",4,1,6,2,-3,"Peri"
"350",19,"GOAT",6,6,4,-2,0,"Peri"
"351",19,"Grandmasterflash",7,5,7,0,-2,"Peri"
"352",19,"havegang7",8,6,8,0,-2,"Peri"
"353",19,"hejhejhund",7,7,7,0,0,"Peri"
"354",19,"JakobBjerreKnudsen",7,7,6,-1,0,"Peri"
"355",19,"Jesper",6,4,2,-4,-2,"Peri"
"356",19,"Johanne",7,4,8,1,-3,"Peri"
"357",19,"Katrine",7,0,7,0,NA,"Peri"
"358",19,"lilla",6,6,8,2,0,"Peri"
"359",19,"Llamaman",7,7,3,-4,0,"Peri"
"360",19,"minime",8,8,7,-1,0,"Peri"
"361",19,"Misterperc",7,7,4,-3,0,"Peri"
"362",19,"Moe",5,3,5,0,-2,"Peri"
"363",19,"Python",6,0,6,0,NA,"Peri"
"364",19,"RBJ",3,3,7,4,0,"Peri"
"365",19,"Rensdyrlam",2,5,7,5,3,"Peri"
"366",19,"rosenmeier",5,3,2,-3,-2,"Peri"
"367",19,"Sarah",5,2,5,0,-3,"Peri"
"368",19,"SKJ",2,0,5,3,NA,"Peri"
"369",19,"Slowlydying",3,0,6,3,NA,"Peri"
"370",19,"SOJ",2,5,4,2,3,"Peri"
"371",19,"wtf",5,5,6,1,0,"Peri"
"372",2,"17",4,1,6,2,-3,"Peri"
"373",2,"1879",4,6,3,-1,2,"Peri"
"374",2,"1918",5,5,1,-4,0,"Peri"
"375",2,"2205",1,0,2,1,NA,"Peri"
"376",2,"4520",3,6,4,1,3,"Peri"
"377",2,"45bites",7,5,3,-4,-2,"Peri"
"378",2,"6107",5,3,4,-1,-2,"Peri"
"379",2,"9696",2,2,2,0,0,"Peri"
"380",2,"andrea",5,7,7,2,2,"Peri"
"381",2,"Asad",5,7,2,-3,2,"Peri"
"382",2,"ASDF1234",6,4,6,0,-2,"Peri"
"383",2,"Astrid",2,0,2,0,NA,"Peri"
"384",2,"Bøllemis",7,4,7,0,-3,"Peri"
"385",2,"Carmesin",4,2,4,0,-2,"Peri"
"386",2,"Christian Jacobsen",6,6,5,-1,0,"Peri"
"387",2,"GOAT",4,0,5,1,NA,"Peri"
"388",2,"Grandmasterflash",6,6,5,-1,0,"Peri"
"389",2,"havegang7",5,3,7,2,-2,"Peri"
"390",2,"hejhejhund",7,0,7,0,NA,"Peri"
"391",2,"JakobBjerreKnudsen",4,4,4,0,0,"Peri"
"392",2,"Jesper",4,6,5,1,2,"Peri"
"393",2,"Johanne",7,4,6,-1,-3,"Peri"
"394",2,"Katrine",5,2,5,0,-3,"Peri"
"395",2,"lilla",5,3,6,1,-2,"Peri"
"396",2,"Llamaman",4,4,5,1,0,"Peri"
"397",2,"minime",8,5,6,-2,-3,"Peri"
"398",2,"Misterperc",4,0,5,1,NA,"Peri"
"399",2,"Moe",3,5,7,4,2,"Peri"
"400",2,"Python",4,4,4,0,0,"Peri"
"401",2,"RBJ",3,1,5,2,-2,"Peri"
"402",2,"Rensdyrlam",6,6,6,0,0,"Peri"
"403",2,"rosenmeier",5,2,5,0,-3,"Peri"
"404",2,"Sarah",4,4,5,1,0,"Peri"
"405",2,"SKJ",6,8,7,1,2,"Peri"
"406",2,"Slowlydying",8,8,8,0,0,"Peri"
"407",2,"SOJ",2,2,6,4,0,"Peri"
"408",2,"wtf",2,2,2,0,0,"Peri"
"409",20,"17",5,2,6,1,-3,"Peri"
"410",20,"1879",6,4,7,1,-2,"Peri"
"411",20,"1918",7,5,7,0,-2,"Peri"
"412",20,"2205",6,6,5,-1,0,"Peri"
"413",20,"4520",5,8,5,0,3,"Peri"
"414",20,"45bites",7,4,8,1,-3,"Peri"
"415",20,"6107",6,4,5,-1,-2,"Peri"
"416",20,"9696",7,7,6,-1,0,"Peri"
"417",20,"andrea",6,0,3,-3,NA,"Peri"
"418",20,"Asad",3,6,2,-1,3,"Peri"
"419",20,"ASDF1234",7,5,6,-1,-2,"Peri"
"420",20,"Astrid",5,8,4,-1,3,"Peri"
"421",20,"Bøllemis",7,4,7,0,-3,"Peri"
"422",20,"Carmesin",4,0,4,0,NA,"Peri"
"423",20,"Christian Jacobsen",6,6,7,1,0,"Peri"
"424",20,"GOAT",6,8,7,1,2,"Peri"
"425",20,"Grandmasterflash",7,4,5,-2,-3,"Peri"
"426",20,"havegang7",8,5,8,0,-3,"Peri"
"427",20,"hejhejhund",6,0,4,-2,NA,"Peri"
"428",20,"Jesper",2,5,3,1,3,"Peri"
"429",20,"Johanne",8,6,8,0,-2,"Peri"
"430",20,"Katrine",6,6,6,0,0,"Peri"
"431",20,"lilla",5,8,6,1,3,"Peri"
"432",20,"Llamaman",4,4,7,3,0,"Peri"
"433",20,"minime",8,5,8,0,-3,"Peri"
"434",20,"Misterperc",8,0,8,0,NA,"Peri"
"435",20,"Moe",8,6,8,0,-2,"Peri"
"436",20,"Python",5,3,5,0,-2,"Peri"
"437",20,"RBJ",3,6,7,4,3,"Peri"
"438",20,"Rensdyrlam",8,6,8,0,-2,"Peri"
"439",20,"rosenmeier",7,0,7,0,NA,"Peri"
"440",20,"Sarah",6,8,7,1,2,"Peri"
"441",20,"SKJ",6,4,6,0,-2,"Peri"
"442",20,"Slowlydying",8,5,8,0,-3,"Peri"
"443",20,"SOJ",1,3,4,3,2,"Peri"
"444",20,"wtf",6,3,6,0,-3,"Peri"
"445",21,"17",1,3,3,2,2,"Peri"
"446",21,"1879",4,2,2,-2,-2,"Peri"
"447",21,"1918",6,4,1,-5,-2,"Peri"
"448",21,"2205",7,4,3,-4,-3,"Peri"
"449",21,"4520",2,4,5,3,2,"Peri"
"450",21,"45bites",4,0,2,-2,NA,"Peri"
"451",21,"6107",6,3,5,-1,-3,"Peri"
"452",21,"9696",2,4,4,2,2,"Peri"
"453",21,"andrea",6,3,3,-3,-3,"Peri"
"454",21,"Asad",3,5,1,-2,2,"Peri"
"455",21,"ASDF1234",5,0,4,-1,NA,"Peri"
"456",21,"Astrid",2,5,3,1,3,"Peri"
"457",21,"Bøllemis",7,7,7,0,0,"Peri"
"458",21,"Carmesin",4,2,5,1,-2,"Peri"
"459",21,"Christian Jacobsen",4,4,4,0,0,"Peri"
"460",21,"GOAT",4,2,5,1,-2,"Peri"
"461",21,"Grandmasterflash",4,2,3,-1,-2,"Peri"
"462",21,"havegang7",6,8,5,-1,2,"Peri"
"463",21,"hejhejhund",6,6,7,1,0,"Peri"
"464",21,"JakobBjerreKnudsen",5,8,3,-2,3,"Peri"
"465",21,"Jesper",4,0,2,-2,NA,"Peri"
"466",21,"Johanne",6,4,7,1,-2,"Peri"
"467",21,"Katrine",6,4,5,-1,-2,"Peri"
"468",21,"lilla",5,5,4,-1,0,"Peri"
"469",21,"Llamaman",8,6,3,-5,-2,"Peri"
"470",21,"minime",6,8,2,-4,2,"Peri"
"471",21,"Misterperc",4,4,2,-2,0,"Peri"
"472",21,"Moe",7,4,7,0,-3,"Peri"
"473",21,"Python",3,6,4,1,3,"Peri"
"474",21,"RBJ",1,3,5,4,2,"Peri"
"475",21,"Rensdyrlam",4,7,1,-3,3,"Peri"
"476",21,"rosenmeier",3,0,3,0,NA,"Peri"
"477",21,"Sarah",5,7,3,-2,2,"Peri"
"478",21,"SKJ",6,6,7,1,0,"Peri"
"479",21,"Slowlydying",5,2,7,2,-3,"Peri"
"480",21,"SOJ",3,6,3,0,3,"Peri"
"481",21,"The cat",8,6,8,0,-2,"Peri"
"482",21,"wtf",3,6,2,-1,3,"Peri"
"483",22,"17",5,3,3,-2,-2,"Peri"
"484",22,"1879",4,1,3,-1,-3,"Peri"
"485",22,"1918",6,4,2,-4,-2,"Peri"
"486",22,"2205",6,4,6,0,-2,"Peri"
"487",22,"4520",3,0,2,-1,NA,"Peri"
"488",22,"45bites",2,4,3,1,2,"Peri"
"489",22,"6107",5,0,4,-1,NA,"Peri"
"490",22,"9696",2,4,2,0,2,"Peri"
"491",22,"andrea",5,7,3,-2,2,"Peri"
"492",22,"Asad",3,0,1,-2,NA,"Peri"
"493",22,"ASDF1234",3,6,4,1,3,"Peri"
"494",22,"Astrid",2,2,5,3,0,"Peri"
"495",22,"Bøllemis",7,7,7,0,0,"Peri"
"496",22,"Carmesin",4,4,3,-1,0,"Peri"
"497",22,"Christian Jacobsen",3,5,3,0,2,"Peri"
"498",22,"GOAT",2,4,2,0,2,"Peri"
"499",22,"Grandmasterflash",8,8,6,-2,0,"Peri"
"500",22,"havegang7",6,8,7,1,2,"Peri"
"501",22,"hejhejhund",5,2,3,-2,-3,"Peri"
"502",22,"JakobBjerreKnudsen",4,6,3,-1,2,"Peri"
"503",22,"Jesper",2,0,1,-1,NA,"Peri"
"504",22,"Johanne",5,5,5,0,0,"Peri"
"505",22,"Katrine",6,4,5,-1,-2,"Peri"
"506",22,"lilla",3,6,4,1,3,"Peri"
"507",22,"Llamaman",3,1,3,0,-2,"Peri"
"508",22,"minime",7,5,7,0,-2,"Peri"
"509",22,"Misterperc",3,3,1,-2,0,"Peri"
"510",22,"Moe",3,6,6,3,3,"Peri"
"511",22,"Python",2,2,6,4,0,"Peri"
"512",22,"RBJ",1,1,5,4,0,"Peri"
"513",22,"Rensdyrlam",1,4,1,0,3,"Peri"
"514",22,"rosenmeier",3,1,2,-1,-2,"Peri"
"515",22,"Sarah",3,3,3,0,0,"Peri"
"516",22,"SKJ",3,6,4,1,3,"Peri"
"517",22,"Slowlydying",7,7,4,-3,0,"Peri"
"518",22,"SOJ",4,7,1,-3,3,"Peri"
"519",22,"wtf",5,5,3,-2,0,"Peri"
"520",23,"17",6,8,6,0,2,"Peri"
"521",23,"1879",4,1,5,1,-3,"Peri"
"522",23,"1918",3,6,1,-2,3,"Peri"
"523",23,"2205",8,8,6,-2,0,"Peri"
"524",23,"4520",5,3,5,0,-2,"Peri"
"525",23,"45bites",7,7,6,-1,0,"Peri"
"526",23,"6107",5,7,4,-1,2,"Peri"
"527",23,"9696",4,2,4,0,-2,"Peri"
"528",23,"andrea",5,5,7,2,0,"Peri"
"529",23,"Asad",6,8,2,-4,2,"Peri"
"530",23,"ASDF1234",6,6,6,0,0,"Peri"
"531",23,"Astrid",6,6,5,-1,0,"Peri"
"532",23,"Bøllemis",7,5,7,0,-2,"Peri"
"533",23,"Carmesin",5,5,5,0,0,"Peri"
"534",23,"Christian Jacobsen",5,3,6,1,-2,"Peri"
"535",23,"GOAT",4,0,4,0,NA,"Peri"
"536",23,"Grandmasterflash",7,5,4,-3,-2,"Peri"
"537",23,"havegang7",6,4,6,0,-2,"Peri"
"538",23,"hejhejhund",8,5,8,0,-3,"Peri"
"539",23,"JakobBjerreKnudsen",5,5,3,-2,0,"Peri"
"540",23,"Jesper",5,5,5,0,0,"Peri"
"541",23,"Johanne",7,5,7,0,-2,"Peri"
"542",23,"Katrine",6,4,6,0,-2,"Peri"
"543",23,"lilla",8,5,8,0,-3,"Peri"
"544",23,"Llamaman",2,5,6,4,3,"Peri"
"545",23,"minime",7,7,3,-4,0,"Peri"
"546",23,"Misterperc",2,5,7,5,3,"Peri"
"547",23,"Moe",8,8,7,-1,0,"Peri"
"548",23,"Python",6,3,6,0,-3,"Peri"
"549",23,"RBJ",2,2,6,4,0,"Peri"
"550",23,"Rensdyrlam",8,8,6,-2,0,"Peri"
"551",23,"rosenmeier",6,6,3,-3,0,"Peri"
"552",23,"Sarah",5,5,5,0,0,"Peri"
"553",23,"SKJ",7,4,7,0,-3,"Peri"
"554",23,"Slowlydying",8,6,8,0,-2,"Peri"
"555",23,"SOJ",3,1,4,1,-2,"Peri"
"556",23,"wtf",3,5,4,1,2,"Peri"
"557",24,"17",6,8,7,1,2,"Peri"
"558",24,"1879",3,1,4,1,-2,"Peri"
"559",24,"1918",6,3,5,-1,-3,"Peri"
"560",24,"2205",6,8,5,-1,2,"Peri"
"561",24,"4520",5,3,6,1,-2,"Peri"
"562",24,"45bites",5,7,5,0,2,"Peri"
"563",24,"6107",4,6,5,1,2,"Peri"
"564",24,"9696",5,5,5,0,0,"Peri"
"565",24,"andrea",6,4,4,-2,-2,"Peri"
"566",24,"Asad",3,3,5,2,0,"Peri"
"567",24,"ASDF1234",5,2,6,1,-3,"Peri"
"568",24,"Astrid",5,7,6,1,2,"Peri"
"569",24,"Bøllemis",7,0,7,0,NA,"Peri"
"570",24,"Carmesin",5,7,4,-1,2,"Peri"
"571",24,"Christian Jacobsen",6,6,7,1,0,"Peri"
"572",24,"GOAT",5,3,5,0,-2,"Peri"
"573",24,"Grandmasterflash",3,5,6,3,2,"Peri"
"574",24,"havegang7",8,8,7,-1,0,"Peri"
"575",24,"hejhejhund",3,6,4,1,3,"Peri"
"576",24,"JakobBjerreKnudsen",6,6,6,0,0,"Peri"
"577",24,"Jesper",3,3,4,1,0,"Peri"
"578",24,"Johanne",8,5,7,-1,-3,"Peri"
"579",24,"Katrine",6,3,6,0,-3,"Peri"
"580",24,"lilla",7,0,5,-2,NA,"Peri"
"581",24,"Llamaman",6,4,7,1,-2,"Peri"
"582",24,"minime",6,3,6,0,-3,"Peri"
"583",24,"Misterperc",6,8,5,-1,2,"Peri"
"584",24,"Moe",6,6,7,1,0,"Peri"
"585",24,"Python",6,6,6,0,0,"Peri"
"586",24,"RBJ",3,6,6,3,3,"Peri"
"587",24,"Rensdyrlam",8,8,7,-1,0,"Peri"
"588",24,"rosenmeier",5,7,3,-2,2,"Peri"
"589",24,"Sarah",6,4,4,-2,-2,"Peri"
"590",24,"SKJ",5,3,6,1,-2,"Peri"
"591",24,"Slowlydying",7,5,8,1,-2,"Peri"
"592",24,"SOJ",2,5,4,2,3,"Peri"
"593",24,"wtf",3,6,4,1,3,"Peri"
"594",25,"17",5,2,5,0,-3,"Peri"
"595",25,"1879",3,6,3,0,3,"Peri"
"596",25,"1918",4,2,4,0,-2,"Peri"
"597",25,"2205",6,6,2,-4,0,"Peri"
"598",25,"4520",6,3,7,1,-3,"Peri"
"599",25,"45bites",3,1,4,1,-2,"Peri"
"600",25,"6107",6,4,4,-2,-2,"Peri"
"601",25,"9696",4,4,2,-2,0,"Peri"
"602",25,"andrea",7,4,7,0,-3,"Peri"
"603",25,"Asad",1,3,3,2,2,"Peri"
"604",25,"ASDF1234",5,8,5,0,3,"Peri"
"605",25,"Astrid",4,6,4,0,2,"Peri"
"606",25,"Bøllemis",7,7,7,0,0,"Peri"
"607",25,"Carmesin",4,1,4,0,-3,"Peri"
"608",25,"Christian Jacobsen",4,4,4,0,0,"Peri"
"609",25,"GOAT",2,5,4,2,3,"Peri"
"610",25,"Grandmasterflash",4,6,5,1,2,"Peri"
"611",25,"havegang7",6,0,6,0,NA,"Peri"
"612",25,"hejhejhund",8,0,4,-4,NA,"Peri"
"613",25,"JakobBjerreKnudsen",7,7,7,0,0,"Peri"
"614",25,"Jesper",3,0,3,0,NA,"Peri"
"615",25,"Johanne",6,6,7,1,0,"Peri"
"616",25,"Katrine",6,8,6,0,2,"Peri"
"617",25,"lilla",5,0,4,-1,NA,"Peri"
"618",25,"Llamaman",8,5,3,-5,-3,"Peri"
"619",25,"minime",4,6,5,1,2,"Peri"
"620",25,"Misterperc",3,6,4,1,3,"Peri"
"621",25,"Moe",5,5,6,1,0,"Peri"
"622",25,"Python",4,2,4,0,-2,"Peri"
"623",25,"RBJ",1,4,6,5,3,"Peri"
"624",25,"Rensdyrlam",8,8,8,0,0,"Peri"
"625",25,"rosenmeier",2,0,3,1,NA,"Peri"
"626",25,"Sarah",4,6,8,4,2,"Peri"
"627",25,"SKJ",6,6,6,0,0,"Peri"
"628",25,"Slowlydying",6,8,8,2,2,"Peri"
"629",25,"SOJ",4,6,5,1,2,"Peri"
"630",25,"The cat",8,6,8,0,-2,"Peri"
"631",25,"wtf",2,0,5,3,NA,"Peri"
"632",26,"17",4,2,7,3,-2,"Peri"
"633",26,"1879",2,4,4,2,2,"Peri"
"634",26,"1918",7,5,2,-5,-2,"Peri"
"635",26,"2205",8,6,8,0,-2,"Peri"
"636",26,"4520",6,4,6,0,-2,"Peri"
"637",26,"45bites",7,5,4,-3,-2,"Peri"
"638",26,"6107",7,4,3,-4,-3,"Peri"
"639",26,"9696",6,0,6,0,NA,"Peri"
"640",26,"andrea",7,7,5,-2,0,"Peri"
"641",26,"Asad",2,2,3,1,0,"Peri"
"642",26,"ASDF1234",5,3,5,0,-2,"Peri"
"643",26,"Astrid",7,0,7,0,NA,"Peri"
"644",26,"Bøllemis",7,0,7,0,NA,"Peri"
"645",26,"Carmesin",4,2,4,0,-2,"Peri"
"646",26,"Christian Jacobsen",7,5,7,0,-2,"Peri"
"647",26,"GOAT",6,4,5,-1,-2,"Peri"
"648",26,"Grandmasterflash",5,2,5,0,-3,"Peri"
"649",26,"havegang7",5,8,8,3,3,"Peri"
"650",26,"hejhejhund",6,3,7,1,-3,"Peri"
"651",26,"JakobBjerreKnudsen",7,7,4,-3,0,"Peri"
"652",26,"Jesper",5,5,2,-3,0,"Peri"
"653",26,"Johanne",8,6,7,-1,-2,"Peri"
"654",26,"Katrine",6,8,6,0,2,"Peri"
"655",26,"lilla",7,7,6,-1,0,"Peri"
"656",26,"Llamaman",7,7,5,-2,0,"Peri"
"657",26,"minime",3,1,3,0,-2,"Peri"
"658",26,"Misterperc",3,0,6,3,NA,"Peri"
"659",26,"Moe",7,0,7,0,NA,"Peri"
"660",26,"Python",5,0,6,1,NA,"Peri"
"661",26,"RBJ",2,4,6,4,2,"Peri"
"662",26,"Rensdyrlam",8,6,8,0,-2,"Peri"
"663",26,"rosenmeier",7,7,6,-1,0,"Peri"
"664",26,"Sarah",7,5,4,-3,-2,"Peri"
"665",26,"SKJ",7,7,8,1,0,"Peri"
"666",26,"Slowlydying",8,0,8,0,NA,"Peri"
"667",26,"SOJ",7,5,4,-3,-2,"Peri"
"668",26,"wtf",4,1,4,0,-3,"Peri"
"669",27,"17",6,4,4,-2,-2,"Peri"
"670",27,"1879",3,6,3,0,3,"Peri"
"671",27,"1918",6,8,8,2,2,"Peri"
"672",27,"2205",5,8,4,-1,3,"Peri"
"673",27,"4520",3,5,3,0,2,"Peri"
"674",27,"45bites",2,2,3,1,0,"Peri"
"675",27,"6107",6,8,7,1,2,"Peri"
"676",27,"9696",2,2,5,3,0,"Peri"
"677",27,"andrea",6,0,3,-3,NA,"Peri"
"678",27,"Asad",2,4,3,1,2,"Peri"
"679",27,"ASDF1234",5,8,5,0,3,"Peri"
"680",27,"Astrid",6,3,8,2,-3,"Peri"
"681",27,"Bøllemis",7,0,7,0,NA,"Peri"
"682",27,"Carmesin",3,6,4,1,3,"Peri"
"683",27,"Christian Jacobsen",6,6,6,0,0,"Peri"
"684",27,"GOAT",5,3,3,-2,-2,"Peri"
"685",27,"Grandmasterflash",7,5,5,-2,-2,"Peri"
"686",27,"havegang7",8,8,8,0,0,"Peri"
"687",27,"hejhejhund",6,6,3,-3,0,"Peri"
"688",27,"JakobBjerreKnudsen",6,8,5,-1,2,"Peri"
"689",27,"Jesper",2,4,2,0,2,"Peri"
"690",27,"Johanne",7,4,6,-1,-3,"Peri"
"691",27,"Katrine",6,0,6,0,NA,"Peri"
"692",27,"lilla",7,4,7,0,-3,"Peri"
"693",27,"Llamaman",3,5,3,0,2,"Peri"
"694",27,"minime",2,5,6,4,3,"Peri"
"695",27,"Misterperc",3,1,5,2,-2,"Peri"
"696",27,"Moe",3,1,7,4,-2,"Peri"
"697",27,"Python",5,5,3,-2,0,"Peri"
"698",27,"RBJ",2,5,6,4,3,"Peri"
"699",27,"Rensdyrlam",7,4,6,-1,-3,"Peri"
"700",27,"rosenmeier",4,1,3,-1,-3,"Peri"
"701",27,"Sarah",7,7,7,0,0,"Peri"
"702",27,"SKJ",5,2,3,-2,-3,"Peri"
"703",27,"Slowlydying",5,3,6,1,-2,"Peri"
"704",27,"SOJ",7,7,4,-3,0,"Peri"
"705",27,"wtf",7,4,5,-2,-3,"Peri"
"706",28,"17",4,6,7,3,2,"Peri"
"707",28,"1879",4,4,2,-2,0,"Peri"
"708",28,"1918",7,5,4,-3,-2,"Peri"
"709",28,"2205",8,8,8,0,0,"Peri"
"710",28,"4520",6,6,5,-1,0,"Peri"
"711",28,"45bites",6,6,5,-1,0,"Peri"
"712",28,"6107",4,6,5,1,2,"Peri"
"713",28,"9696",6,3,4,-2,-3,"Peri"
"714",28,"andrea",7,5,6,-1,-2,"Peri"
"715",28,"Asad",4,0,5,1,NA,"Peri"
"716",28,"ASDF1234",5,7,4,-1,2,"Peri"
"717",28,"Astrid",4,0,5,1,NA,"Peri"
"718",28,"Bøllemis",7,0,7,0,NA,"Peri"
"719",28,"Carmesin",4,2,5,1,-2,"Peri"
"720",28,"Christian Jacobsen",6,8,6,0,2,"Peri"
"721",28,"GOAT",7,0,6,-1,NA,"Peri"
"722",28,"Grandmasterflash",4,1,5,1,-3,"Peri"
"723",28,"havegang7",7,5,8,1,-2,"Peri"
"724",28,"hejhejhund",6,4,6,0,-2,"Peri"
"725",28,"JakobBjerreKnudsen",4,7,5,1,3,"Peri"
"726",28,"Jesper",6,6,3,-3,0,"Peri"
"727",28,"Johanne",6,8,6,0,2,"Peri"
"728",28,"Katrine",6,4,7,1,-2,"Peri"
"729",28,"lilla",5,3,5,0,-2,"Peri"
"730",28,"Llamaman",5,7,5,0,2,"Peri"
"731",28,"minime",6,6,6,0,0,"Peri"
"732",28,"Misterperc",5,2,3,-2,-3,"Peri"
"733",28,"Moe",6,4,7,1,-2,"Peri"
"734",28,"Python",5,7,5,0,2,"Peri"
"735",28,"RBJ",2,0,6,4,NA,"Peri"
"736",28,"Rensdyrlam",7,4,4,-3,-3,"Peri"
"737",28,"rosenmeier",5,3,5,0,-2,"Peri"
"738",28,"Sarah",6,3,3,-3,-3,"Peri"
"739",28,"SKJ",7,4,7,0,-3,"Peri"
"740",28,"Slowlydying",6,6,7,1,0,"Peri"
"741",28,"SOJ",4,4,6,2,0,"Peri"
"742",28,"wtf",4,0,4,0,NA,"Peri"
"743",29,"17",5,2,7,2,-3,"Peri"
"744",29,"1879",6,6,7,1,0,"Peri"
"745",29,"1918",7,5,2,-5,-2,"Peri"
"746",29,"2205",8,6,8,0,-2,"Peri"
"747",29,"4520",7,4,6,-1,-3,"Peri"
"748",29,"45bites",8,6,6,-2,-2,"Peri"
"749",29,"6107",6,3,7,1,-3,"Peri"
"750",29,"9696",8,6,7,-1,-2,"Peri"
"751",29,"andrea",7,0,5,-2,NA,"Peri"
"752",29,"Asad",6,8,6,0,2,"Peri"
"753",29,"ASDF1234",5,0,6,1,NA,"Peri"
"754",29,"Astrid",8,6,7,-1,-2,"Peri"
"755",29,"Bøllemis",7,0,7,0,NA,"Peri"
"756",29,"Carmesin",5,2,5,0,-3,"Peri"
"757",29,"Christian Jacobsen",7,5,5,-2,-2,"Peri"
"758",29,"GOAT",8,0,7,-1,NA,"Peri"
"759",29,"Grandmasterflash",4,6,4,0,2,"Peri"
"760",29,"havegang7",7,0,8,1,NA,"Peri"
"761",29,"hejhejhund",8,8,7,-1,0,"Peri"
"762",29,"JakobBjerreKnudsen",8,6,7,-1,-2,"Peri"
"763",29,"Jesper",3,0,3,0,NA,"Peri"
"764",29,"Johanne",8,8,8,0,0,"Peri"
"765",29,"Katrine",6,8,6,0,2,"Peri"
"766",29,"lilla",8,8,5,-3,0,"Peri"
"767",29,"Llamaman",8,0,6,-2,NA,"Peri"
"768",29,"minime",7,7,6,-1,0,"Peri"
"769",29,"Misterperc",8,5,8,0,-3,"Peri"
"770",29,"Moe",5,3,6,1,-2,"Peri"
"771",29,"Python",3,5,5,2,2,"Peri"
"772",29,"RBJ",5,0,7,2,NA,"Peri"
"773",29,"Rensdyrlam",8,8,8,0,0,"Peri"
"774",29,"rosenmeier",7,5,6,-1,-2,"Peri"
"775",29,"Sarah",7,7,6,-1,0,"Peri"
"776",29,"SKJ",7,4,8,1,-3,"Peri"
"777",29,"Slowlydying",8,6,8,0,-2,"Peri"
"778",29,"SOJ",5,0,7,2,NA,"Peri"
"779",29,"wtf",5,7,6,1,2,"Peri"
"780",3,"17",3,6,5,2,3,"Peri"
"781",3,"1879",4,1,4,0,-3,"Peri"
"782",3,"1918",4,0,3,-1,NA,"Peri"
"783",3,"2205",1,1,2,1,0,"Peri"
"784",3,"4520",3,3,3,0,0,"Peri"
"785",3,"45bites",3,5,3,0,2,"Peri"
"786",3,"6107",4,2,4,0,-2,"Peri"
"787",3,"9696",4,0,5,1,NA,"Peri"
"788",3,"andrea",5,3,7,2,-2,"Peri"
"789",3,"Asad",4,1,1,-3,-3,"Peri"
"790",3,"ASDF1234",5,3,5,0,-2,"Peri"
"791",3,"Astrid",4,1,5,1,-3,"Peri"
"792",3,"Bøllemis",7,4,7,0,-3,"Peri"
"793",3,"Carmesin",3,3,4,1,0,"Peri"
"794",3,"Christian Jacobsen",3,6,3,0,3,"Peri"
"795",3,"GOAT",3,5,3,0,2,"Peri"
"796",3,"Grandmasterflash",3,5,4,1,2,"Peri"
"797",3,"havegang7",7,4,5,-2,-3,"Peri"
"798",3,"hejhejhund",5,5,4,-1,0,"Peri"
"799",3,"JakobBjerreKnudsen",4,7,4,0,3,"Peri"
"800",3,"Jesper",2,4,2,0,2,"Peri"
"801",3,"Johanne",7,4,6,-1,-3,"Peri"
"802",3,"Katrine",5,2,6,1,-3,"Peri"
"803",3,"lilla",4,1,4,0,-3,"Peri"
"804",3,"Llamaman",3,3,4,1,0,"Peri"
"805",3,"minime",6,4,5,-1,-2,"Peri"
"806",3,"Misterperc",5,3,4,-1,-2,"Peri"
"807",3,"Moe",2,5,7,5,3,"Peri"
"808",3,"Python",2,5,4,2,3,"Peri"
"809",3,"RBJ",3,0,6,3,NA,"Peri"
"810",3,"Rensdyrlam",2,5,4,2,3,"Peri"
"811",3,"rosenmeier",5,3,4,-1,-2,"Peri"
"812",3,"Sarah",6,0,6,0,NA,"Peri"
"813",3,"SKJ",5,3,5,0,-2,"Peri"
"814",3,"Slowlydying",4,4,4,0,0,"Peri"
"815",3,"SOJ",5,8,3,-2,3,"Peri"
"816",3,"wtf",3,0,3,0,NA,"Peri"
"817",30,"17",6,6,6,0,0,"Peri"
"818",30,"1879",3,3,6,3,0,"Peri"
"819",30,"1918",4,4,4,0,0,"Peri"
"820",30,"2205",3,5,3,0,2,"Peri"
"821",30,"4520",5,8,4,-1,3,"Peri"
"822",30,"45bites",6,4,5,-1,-2,"Peri"
"823",30,"6107",7,5,5,-2,-2,"Peri"
"824",30,"9696",3,1,4,1,-2,"Peri"
"825",30,"andrea",6,4,4,-2,-2,"Peri"
"826",30,"Asad",1,3,1,0,2,"Peri"
"827",30,"ASDF1234",3,6,3,0,3,"Peri"
"828",30,"Astrid",7,7,4,-3,0,"Peri"
"829",30,"Bøllemis",7,5,7,0,-2,"Peri"
"830",30,"Carmesin",7,0,4,-3,NA,"Peri"
"831",30,"Christian Jacobsen",3,0,3,0,NA,"Peri"
"832",30,"GOAT",2,4,3,1,2,"Peri"
"833",30,"Grandmasterflash",7,7,6,-1,0,"Peri"
"834",30,"havegang7",6,4,7,1,-2,"Peri"
"835",30,"hejhejhund",4,6,6,2,2,"Peri"
"836",30,"Jesper",5,7,2,-3,2,"Peri"
"837",30,"Johanne",7,0,7,0,NA,"Peri"
"838",30,"Katrine",5,2,6,1,-3,"Peri"
"839",30,"lilla",5,7,5,0,2,"Peri"
"840",30,"Llamaman",2,4,4,2,2,"Peri"
"841",30,"minime",3,5,7,4,2,"Peri"
"842",30,"Misterperc",7,5,6,-1,-2,"Peri"
"843",30,"Moe",7,0,3,-4,NA,"Peri"
"844",30,"Python",7,4,5,-2,-3,"Peri"
"845",30,"RBJ",2,4,5,3,2,"Peri"
"846",30,"Rensdyrlam",7,7,7,0,0,"Peri"
"847",30,"rosenmeier",5,2,4,-1,-3,"Peri"
"848",30,"Sarah",2,2,5,3,0,"Peri"
"849",30,"SKJ",8,5,7,-1,-3,"Peri"
"850",30,"Slowlydying",8,8,5,-3,0,"Peri"
"851",30,"SOJ",5,7,4,-1,2,"Peri"
"852",30,"wtf",5,8,6,1,3,"Peri"
"853",31,"17",6,6,3,-3,0,"Peri"
"854",31,"1879",3,0,5,2,NA,"Peri"
"855",31,"1918",3,6,5,2,3,"Peri"
"856",31,"2205",3,1,5,2,-2,"Peri"
"857",31,"4520",7,5,4,-3,-2,"Peri"
"858",31,"45bites",4,6,4,0,2,"Peri"
"859",31,"6107",6,6,6,0,0,"Peri"
"860",31,"9696",6,0,6,0,NA,"Peri"
"861",31,"andrea",5,0,5,0,NA,"Peri"
"862",31,"Asad",2,2,3,1,0,"Peri"
"863",31,"ASDF1234",5,0,5,0,NA,"Peri"
"864",31,"Astrid",7,5,5,-2,-2,"Peri"
"865",31,"Bøllemis",7,4,7,0,-3,"Peri"
"866",31,"Carmesin",2,5,3,1,3,"Peri"
"867",31,"Christian Jacobsen",4,6,4,0,2,"Peri"
"868",31,"GOAT",6,6,5,-1,0,"Peri"
"869",31,"Grandmasterflash",5,0,5,0,NA,"Peri"
"870",31,"havegang7",8,5,8,0,-3,"Peri"
"871",31,"hejhejhund",7,7,3,-4,0,"Peri"
"872",31,"JakobBjerreKnudsen",5,3,5,0,-2,"Peri"
"873",31,"Jesper",3,6,4,1,3,"Peri"
"874",31,"Johanne",7,4,8,1,-3,"Peri"
"875",31,"Katrine",6,8,6,0,2,"Peri"
"876",31,"lilla",7,5,8,1,-2,"Peri"
"877",31,"Llamaman",5,7,5,0,2,"Peri"
"878",31,"minime",2,4,6,4,2,"Peri"
"879",31,"Misterperc",5,2,4,-1,-3,"Peri"
"880",31,"Moe",6,3,5,-1,-3,"Peri"
"881",31,"Python",6,4,5,-1,-2,"Peri"
"882",31,"RBJ",2,5,6,4,3,"Peri"
"883",31,"Rensdyrlam",8,6,7,-1,-2,"Peri"
"884",31,"rosenmeier",6,3,4,-2,-3,"Peri"
"885",31,"Sarah",4,2,5,1,-2,"Peri"
"886",31,"SKJ",7,4,6,-1,-3,"Peri"
"887",31,"Slowlydying",8,8,8,0,0,"Peri"
"888",31,"SOJ",6,6,5,-1,0,"Peri"
"889",31,"wtf",4,2,2,-2,-2,"Peri"
"890",32,"17",4,2,5,1,-2,"Peri"
"891",32,"1879",4,2,4,0,-2,"Peri"
"892",32,"1918",5,8,3,-2,3,"Peri"
"893",32,"2205",5,5,4,-1,0,"Peri"
"894",32,"4520",4,4,4,0,0,"Peri"
"895",32,"45bites",5,8,5,0,3,"Peri"
"896",32,"6107",6,6,6,0,0,"Peri"
"897",32,"9696",3,6,3,0,3,"Peri"
"898",32,"andrea",7,7,6,-1,0,"Peri"
"899",32,"Asad",5,8,5,0,3,"Peri"
"900",32,"ASDF1234",6,6,6,0,0,"Peri"
"901",32,"Astrid",3,1,5,2,-2,"Peri"
"902",32,"Bøllemis",7,0,7,0,NA,"Peri"
"903",32,"Carmesin",3,3,3,0,0,"Peri"
"904",32,"Christian Jacobsen",5,2,5,0,-3,"Peri"
"905",32,"GOAT",3,0,3,0,NA,"Peri"
"906",32,"Grandmasterflash",3,0,4,1,NA,"Peri"
"907",32,"havegang7",7,4,7,0,-3,"Peri"
"908",32,"hejhejhund",6,8,5,-1,2,"Peri"
"909",32,"JakobBjerreKnudsen",5,3,6,1,-2,"Peri"
"910",32,"Jesper",2,2,2,0,0,"Peri"
"911",32,"Johanne",7,4,6,-1,-3,"Peri"
"912",32,"Katrine",5,3,6,1,-2,"Peri"
"913",32,"lilla",4,4,4,0,0,"Peri"
"914",32,"Llamaman",3,3,4,1,0,"Peri"
"915",32,"minime",7,7,7,0,0,"Peri"
"916",32,"Misterperc",3,3,4,1,0,"Peri"
"917",32,"Moe",4,0,7,3,NA,"Peri"
"918",32,"Python",6,6,5,-1,0,"Peri"
"919",32,"RBJ",2,0,5,3,NA,"Peri"
"920",32,"Rensdyrlam",3,1,5,2,-2,"Peri"
"921",32,"rosenmeier",5,2,4,-1,-3,"Peri"
"922",32,"Sarah",4,4,3,-1,0,"Peri"
"923",32,"SKJ",5,7,5,0,2,"Peri"
"924",32,"Slowlydying",7,7,6,-1,0,"Peri"
"925",32,"SOJ",6,6,5,-1,0,"Peri"
"926",32,"The cat",8,6,8,0,-2,"Peri"
"927",32,"wtf",4,2,4,0,-2,"Peri"
"928",33,"17",5,3,5,0,-2,"Peri"
"929",33,"1879",3,6,7,4,3,"Peri"
"930",33,"1918",6,6,4,-2,0,"Peri"
"931",33,"2205",3,0,1,-2,NA,"Peri"
"932",33,"4520",5,7,4,-1,2,"Peri"
"933",33,"45bites",3,5,3,0,2,"Peri"
"934",33,"6107",5,2,5,0,-3,"Peri"
"935",33,"9696",4,7,5,1,3,"Peri"
"936",33,"andrea",8,5,8,0,-3,"Peri"
"937",33,"Asad",2,2,5,3,0,"Peri"
"938",33,"ASDF1234",5,7,6,1,2,"Peri"
"939",33,"Astrid",3,3,2,-1,0,"Peri"
"940",33,"Bøllemis",7,5,7,0,-2,"Peri"
"941",33,"Carmesin",5,2,4,-1,-3,"Peri"
"942",33,"Christian Jacobsen",5,7,4,-1,2,"Peri"
"943",33,"GOAT",6,3,3,-3,-3,"Peri"
"944",33,"Grandmasterflash",6,6,5,-1,0,"Peri"
"945",33,"havegang7",6,8,6,0,2,"Peri"
"946",33,"hejhejhund",7,4,7,0,-3,"Peri"
"947",33,"JakobBjerreKnudsen",7,7,6,-1,0,"Peri"
"948",33,"Jesper",2,2,1,-1,0,"Peri"
"949",33,"Johanne",6,0,6,0,NA,"Peri"
"950",33,"Katrine",5,5,6,1,0,"Peri"
"951",33,"lilla",5,7,5,0,2,"Peri"
"952",33,"Llamaman",6,6,5,-1,0,"Peri"
"953",33,"minime",3,3,5,2,0,"Peri"
"954",33,"Misterperc",6,6,6,0,0,"Peri"
"955",33,"Moe",8,6,6,-2,-2,"Peri"
"956",33,"Python",2,2,3,1,0,"Peri"
"957",33,"RBJ",2,4,5,3,2,"Peri"
"958",33,"Rensdyrlam",8,8,8,0,0,"Peri"
"959",33,"rosenmeier",3,5,3,0,2,"Peri"
"960",33,"Sarah",6,0,6,0,NA,"Peri"
"961",33,"SKJ",3,5,3,0,2,"Peri"
"962",33,"Slowlydying",5,7,7,2,2,"Peri"
"963",33,"SOJ",4,6,4,0,2,"Peri"
"964",33,"wtf",3,5,4,1,2,"Peri"
"965",34,"17",6,4,5,-1,-2,"Peri"
"966",34,"1879",4,4,4,0,0,"Peri"
"967",34,"1918",4,1,4,0,-3,"Peri"
"968",34,"2205",7,7,7,0,0,"Peri"
"969",34,"4520",3,0,2,-1,NA,"Peri"
"970",34,"45bites",5,0,3,-2,NA,"Peri"
"971",34,"6107",7,7,7,0,0,"Peri"
"972",34,"9696",4,7,4,0,3,"Peri"
"973",34,"andrea",7,7,5,-2,0,"Peri"
"974",34,"Asad",3,6,3,0,3,"Peri"
"975",34,"ASDF1234",5,7,5,0,2,"Peri"
"976",34,"Astrid",3,1,4,1,-2,"Peri"
"977",34,"Bøllemis",7,0,7,0,NA,"Peri"
"978",34,"Carmesin",3,5,4,1,2,"Peri"
"979",34,"Christian Jacobsen",6,4,6,0,-2,"Peri"
"980",34,"GOAT",2,4,4,2,2,"Peri"
"981",34,"Grandmasterflash",3,1,5,2,-2,"Peri"
"982",34,"havegang7",6,0,7,1,NA,"Peri"
"983",34,"hejhejhund",6,3,5,-1,-3,"Peri"
"984",34,"JakobBjerreKnudsen",5,2,6,1,-3,"Peri"
"985",34,"Jesper",3,3,1,-2,0,"Peri"
"986",34,"Johanne",6,6,6,0,0,"Peri"
"987",34,"Katrine",5,7,5,0,2,"Peri"
"988",34,"lilla",5,5,6,1,0,"Peri"
"989",34,"Llamaman",7,5,6,-1,-2,"Peri"
"990",34,"minime",7,7,7,0,0,"Peri"
"991",34,"Misterperc",4,7,4,0,3,"Peri"
"992",34,"Moe",5,2,5,0,-3,"Peri"
"993",34,"Python",5,3,5,0,-2,"Peri"
"994",34,"RBJ",1,1,5,4,0,"Peri"
"995",34,"Rensdyrlam",4,7,3,-1,3,"Peri"
"996",34,"rosenmeier",3,0,3,0,NA,"Peri"
"997",34,"Sarah",8,8,5,-3,0,"Peri"
"998",34,"SKJ",8,6,6,-2,-2,"Peri"
"999",34,"Slowlydying",6,4,6,0,-2,"Peri"
"1000",34,"SOJ",4,6,1,-3,2,"Peri"
"1001",34,"wtf",5,3,3,-2,-2,"Peri"
"1002",35,"17",6,3,5,-1,-3,"Peri"
"1003",35,"1879",5,3,7,2,-2,"Peri"
"1004",35,"1918",5,8,2,-3,3,"Peri"
"1005",35,"2205",8,8,7,-1,0,"Peri"
"1006",35,"4520",3,5,3,0,2,"Peri"
"1007",35,"45bites",5,7,6,1,2,"Peri"
"1008",35,"6107",3,1,4,1,-2,"Peri"
"1009",35,"9696",8,5,7,-1,-3,"Peri"
"1010",35,"andrea",6,6,8,2,0,"Peri"
"1011",35,"Asad",5,2,3,-2,-3,"Peri"
"1012",35,"ASDF1234",6,6,5,-1,0,"Peri"
"1013",35,"Astrid",6,6,4,-2,0,"Peri"
"1014",35,"Bøllemis",7,7,7,0,0,"Peri"
"1015",35,"Carmesin",4,1,5,1,-3,"Peri"
"1016",35,"Christian Jacobsen",6,4,6,0,-2,"Peri"
"1017",35,"GOAT",3,6,6,3,3,"Peri"
"1018",35,"Grandmasterflash",5,5,5,0,0,"Peri"
"1019",35,"havegang7",8,6,7,-1,-2,"Peri"
"1020",35,"hejhejhund",4,1,4,0,-3,"Peri"
"1021",35,"Jesper",3,0,3,0,NA,"Peri"
"1022",35,"Johanne",8,6,7,-1,-2,"Peri"
"1023",35,"Katrine",6,6,6,0,0,"Peri"
"1024",35,"lilla",7,7,5,-2,0,"Peri"
"1025",35,"Llamaman",3,3,3,0,0,"Peri"
"1026",35,"minime",8,0,8,0,NA,"Peri"
"1027",35,"Misterperc",7,5,8,1,-2,"Peri"
"1028",35,"Moe",4,2,8,4,-2,"Peri"
"1029",35,"Python",5,3,6,1,-2,"Peri"
"1030",35,"RBJ",5,7,6,1,2,"Peri"
"1031",35,"Rensdyrlam",8,8,8,0,0,"Peri"
"1032",35,"rosenmeier",8,8,6,-2,0,"Peri"
"1033",35,"Sarah",3,5,7,4,2,"Peri"
"1034",35,"SKJ",4,6,7,3,2,"Peri"
"1035",35,"Slowlydying",8,5,8,0,-3,"Peri"
"1036",35,"SOJ",6,8,7,1,2,"Peri"
"1037",35,"wtf",4,4,6,2,0,"Peri"
"1038",36,"17",6,0,3,-3,NA,"Peri"
"1039",36,"1879",4,6,4,0,2,"Peri"
"1040",36,"1918",5,7,6,1,2,"Peri"
"1041",36,"2205",3,6,4,1,3,"Peri"
"1042",36,"4520",3,1,5,2,-2,"Peri"
"1043",36,"45bites",4,0,3,-1,NA,"Peri"
"1044",36,"6107",4,6,5,1,2,"Peri"
"1045",36,"9696",1,1,3,2,0,"Peri"
"1046",36,"andrea",7,5,3,-4,-2,"Peri"
"1047",36,"Asad",6,4,5,-1,-2,"Peri"
"1048",36,"ASDF1234",5,0,4,-1,NA,"Peri"
"1049",36,"Astrid",4,2,2,-2,-2,"Peri"
"1050",36,"Bøllemis",7,7,7,0,0,"Peri"
"1051",36,"Carmesin",3,5,5,2,2,"Peri"
"1052",36,"Christian Jacobsen",5,5,3,-2,0,"Peri"
"1053",36,"GOAT",2,4,2,0,2,"Peri"
"1054",36,"Grandmasterflash",6,8,3,-3,2,"Peri"
"1055",36,"havegang7",6,4,6,0,-2,"Peri"
"1056",36,"hejhejhund",6,3,4,-2,-3,"Peri"
"1057",36,"JakobBjerreKnudsen",6,4,4,-2,-2,"Peri"
"1058",36,"Jesper",4,6,3,-1,2,"Peri"
"1059",36,"Johanne",6,6,7,1,0,"Peri"
"1060",36,"Katrine",6,6,6,0,0,"Peri"
"1061",36,"lilla",3,5,4,1,2,"Peri"
"1062",36,"Llamaman",5,2,6,1,-3,"Peri"
"1063",36,"minime",3,5,5,2,2,"Peri"
"1064",36,"Misterperc",6,3,4,-2,-3,"Peri"
"1065",36,"Moe",4,0,4,0,NA,"Peri"
"1066",36,"Python",1,1,2,1,0,"Peri"
"1067",36,"RBJ",2,5,6,4,3,"Peri"
"1068",36,"Rensdyrlam",3,1,1,-2,-2,"Peri"
"1069",36,"rosenmeier",3,1,4,1,-2,"Peri"
"1070",36,"Sarah",6,8,6,0,2,"Peri"
"1071",36,"SKJ",6,0,5,-1,NA,"Peri"
"1072",36,"Slowlydying",6,4,7,1,-2,"Peri"
"1073",36,"SOJ",3,1,3,0,-2,"Peri"
"1074",36,"The cat",8,5,8,0,-3,"Peri"
"1075",36,"wtf",2,5,2,0,3,"Peri"
"1076",37,"17",5,7,5,0,2,"Peri"
"1077",37,"1879",4,1,4,0,-3,"Peri"
"1078",37,"1918",5,8,3,-2,3,"Peri"
"1079",37,"2205",5,8,3,-2,3,"Peri"
"1080",37,"4520",4,7,3,-1,3,"Peri"
"1081",37,"45bites",7,5,6,-1,-2,"Peri"
"1082",37,"6107",4,1,5,1,-3,"Peri"
"1083",37,"9696",8,5,7,-1,-3,"Peri"
"1084",37,"andrea",7,5,3,-4,-2,"Peri"
"1085",37,"Asad",7,5,6,-1,-2,"Peri"
"1086",37,"ASDF1234",5,2,6,1,-3,"Peri"
"1087",37,"Astrid",7,0,8,1,NA,"Peri"
"1088",37,"Bøllemis",7,4,7,0,-3,"Peri"
"1089",37,"Carmesin",7,5,5,-2,-2,"Peri"
"1090",37,"Christian Jacobsen",6,3,6,0,-3,"Peri"
"1091",37,"GOAT",5,3,6,1,-2,"Peri"
"1092",37,"Grandmasterflash",6,4,4,-2,-2,"Peri"
"1093",37,"havegang7",8,8,8,0,0,"Peri"
"1094",37,"hejhejhund",5,7,4,-1,2,"Peri"
"1095",37,"JakobBjerreKnudsen",7,4,7,0,-3,"Peri"
"1096",37,"Jesper",2,5,5,3,3,"Peri"
"1097",37,"Johanne",7,4,8,1,-3,"Peri"
"1098",37,"Katrine",6,8,6,0,2,"Peri"
"1099",37,"lilla",8,0,8,0,NA,"Peri"
"1100",37,"Llamaman",5,0,6,1,NA,"Peri"
"1101",37,"minime",7,7,6,-1,0,"Peri"
"1102",37,"Misterperc",6,3,6,0,-3,"Peri"
"1103",37,"Moe",6,3,7,1,-3,"Peri"
"1104",37,"Python",5,5,3,-2,0,"Peri"
"1105",37,"RBJ",2,2,6,4,0,"Peri"
"1106",37,"Rensdyrlam",8,6,7,-1,-2,"Peri"
"1107",37,"rosenmeier",5,8,5,0,3,"Peri"
"1108",37,"Sarah",6,8,6,0,2,"Peri"
"1109",37,"SKJ",7,4,6,-1,-3,"Peri"
"1110",37,"Slowlydying",8,8,8,0,0,"Peri"
"1111",37,"SOJ",5,2,5,0,-3,"Peri"
"1112",37,"wtf",3,6,4,1,3,"Peri"
"1113",38,"17",4,1,3,-1,-3,"Peri"
"1114",38,"1879",2,4,2,0,2,"Peri"
"1115",38,"1918",3,5,6,3,2,"Peri"
"1116",38,"2205",3,3,2,-1,0,"Peri"
"1117",38,"4520",2,4,3,1,2,"Peri"
"1118",38,"45bites",2,4,4,2,2,"Peri"
"1119",38,"6107",2,0,3,1,NA,"Peri"
"1120",38,"9696",1,3,1,0,2,"Peri"
"1121",38,"andrea",5,7,3,-2,2,"Peri"
"1122",38,"Asad",5,3,2,-3,-2,"Peri"
"1123",38,"ASDF1234",3,3,4,1,0,"Peri"
"1124",38,"Astrid",2,4,3,1,2,"Peri"
"1125",38,"Bøllemis",7,4,7,0,-3,"Peri"
"1126",38,"Carmesin",2,2,5,3,0,"Peri"
"1127",38,"Christian Jacobsen",6,0,4,-2,NA,"Peri"
"1128",38,"GOAT",3,5,3,0,2,"Peri"
"1129",38,"Grandmasterflash",2,2,3,1,0,"Peri"
"1130",38,"havegang7",5,5,5,0,0,"Peri"
"1131",38,"hejhejhund",5,3,3,-2,-2,"Peri"
"1132",38,"Jesper",5,2,1,-4,-3,"Peri"
"1133",38,"Johanne",6,0,6,0,NA,"Peri"
"1134",38,"Katrine",5,2,5,0,-3,"Peri"
"1135",38,"lilla",4,7,4,0,3,"Peri"
"1136",38,"Llamaman",3,6,4,1,3,"Peri"
"1137",38,"minime",5,7,3,-2,2,"Peri"
"1138",38,"Misterperc",3,5,4,1,2,"Peri"
"1139",38,"Moe",1,3,5,4,2,"Peri"
"1140",38,"Python",3,5,1,-2,2,"Peri"
"1141",38,"RBJ",1,1,5,4,0,"Peri"
"1142",38,"Rensdyrlam",1,4,1,0,3,"Peri"
"1143",38,"rosenmeier",2,2,1,-1,0,"Peri"
"1144",38,"Sarah",3,6,4,1,3,"Peri"
"1145",38,"SKJ",3,1,4,1,-2,"Peri"
"1146",38,"Slowlydying",6,3,5,-1,-3,"Peri"
"1147",38,"SOJ",5,5,1,-4,0,"Peri"
"1148",38,"wtf",2,2,4,2,0,"Peri"
"1149",39,"17",6,0,5,-1,NA,"Peri"
"1150",39,"1879",3,1,3,0,-2,"Peri"
"1151",39,"1918",6,0,6,0,NA,"Peri"
"1152",39,"2205",1,4,1,0,3,"Peri"
"1153",39,"4520",4,0,3,-1,NA,"Peri"
"1154",39,"45bites",3,1,2,-1,-2,"Peri"
"1155",39,"6107",3,6,5,2,3,"Peri"
"1156",39,"9696",2,2,4,2,0,"Peri"
"1157",39,"andrea",5,5,3,-2,0,"Peri"
"1158",39,"Asad",6,6,2,-4,0,"Peri"
"1159",39,"ASDF1234",5,5,4,-1,0,"Peri"
"1160",39,"Astrid",6,8,5,-1,2,"Peri"
"1161",39,"Bøllemis",7,5,7,0,-2,"Peri"
"1162",39,"Carmesin",7,7,5,-2,0,"Peri"
"1163",39,"Christian Jacobsen",4,2,6,2,-2,"Peri"
"1164",39,"GOAT",2,4,3,1,2,"Peri"
"1165",39,"Grandmasterflash",2,5,4,2,3,"Peri"
"1166",39,"havegang7",7,7,8,1,0,"Peri"
"1167",39,"hejhejhund",5,3,5,0,-2,"Peri"
"1168",39,"JakobBjerreKnudsen",4,6,5,1,2,"Peri"
"1169",39,"Jesper",3,5,2,-1,2,"Peri"
"1170",39,"Johanne",6,4,6,0,-2,"Peri"
"1171",39,"Katrine",6,0,6,0,NA,"Peri"
"1172",39,"lilla",2,4,4,2,2,"Peri"
"1173",39,"Llamaman",3,6,3,0,3,"Peri"
"1174",39,"minime",2,4,7,5,2,"Peri"
"1175",39,"Misterperc",2,5,6,4,3,"Peri"
"1176",39,"Moe",4,2,7,3,-2,"Peri"
"1177",39,"Python",4,0,5,1,NA,"Peri"
"1178",39,"RBJ",1,3,5,4,2,"Peri"
"1179",39,"Rensdyrlam",6,6,6,0,0,"Peri"
"1180",39,"rosenmeier",5,7,2,-3,2,"Peri"
"1181",39,"Sarah",4,2,4,0,-2,"Peri"
"1182",39,"SKJ",3,5,5,2,2,"Peri"
"1183",39,"Slowlydying",7,7,6,-1,0,"Peri"
"1184",39,"SOJ",3,5,2,-1,2,"Peri"
"1185",39,"wtf",2,5,2,0,3,"Peri"
"1186",4,"17",1,3,6,5,2,"Peri"
"1187",4,"1879",4,1,5,1,-3,"Peri"
"1188",4,"1918",6,8,3,-3,2,"Peri"
"1189",4,"2205",5,5,6,1,0,"Peri"
"1190",4,"4520",3,3,2,-1,0,"Peri"
"1191",4,"45bites",5,5,6,1,0,"Peri"
"1192",4,"6107",5,2,5,0,-3,"Peri"
"1193",4,"9696",3,5,3,0,2,"Peri"
"1194",4,"andrea",6,6,7,1,0,"Peri"
"1195",4,"Asad",3,3,5,2,0,"Peri"
"1196",4,"ASDF1234",6,4,4,-2,-2,"Peri"
"1197",4,"Astrid",7,0,6,-1,NA,"Peri"
"1198",4,"Bøllemis",7,4,7,0,-3,"Peri"
"1199",4,"Carmesin",5,7,5,0,2,"Peri"
"1200",4,"Christian Jacobsen",6,6,4,-2,0,"Peri"
"1201",4,"GOAT",3,1,3,0,-2,"Peri"
"1202",4,"Grandmasterflash",5,3,4,-1,-2,"Peri"
"1203",4,"havegang7",5,8,7,2,3,"Peri"
"1204",4,"hejhejhund",6,4,4,-2,-2,"Peri"
"1205",4,"JakobBjerreKnudsen",5,8,4,-1,3,"Peri"
"1206",4,"Jesper",5,7,5,0,2,"Peri"
"1207",4,"Johanne",8,5,7,-1,-3,"Peri"
"1208",4,"Katrine",5,0,6,1,NA,"Peri"
"1209",4,"lilla",8,5,4,-4,-3,"Peri"
"1210",4,"Llamaman",5,3,6,1,-2,"Peri"
"1211",4,"minime",3,3,7,4,0,"Peri"
"1212",4,"Misterperc",4,2,3,-1,-2,"Peri"
"1213",4,"Moe",4,6,5,1,2,"Peri"
"1214",4,"Python",6,6,5,-1,0,"Peri"
"1215",4,"RBJ",2,5,6,4,3,"Peri"
"1216",4,"Rensdyrlam",2,2,6,4,0,"Peri"
"1217",4,"rosenmeier",5,2,5,0,-3,"Peri"
"1218",4,"Sarah",5,8,5,0,3,"Peri"
"1219",4,"SKJ",3,0,8,5,NA,"Peri"
"1220",4,"Slowlydying",8,5,8,0,-3,"Peri"
"1221",4,"SOJ",3,1,5,2,-2,"Peri"
"1222",4,"The cat",8,6,8,0,-2,"Peri"
"1223",4,"wtf",6,4,6,0,-2,"Peri"
"1224",40,"17",6,8,5,-1,2,"Peri"
"1225",40,"1879",3,1,4,1,-2,"Peri"
"1226",40,"1918",6,4,5,-1,-2,"Peri"
"1227",40,"2205",6,6,6,0,0,"Peri"
"1228",40,"4520",6,8,5,-1,2,"Peri"
"1229",40,"45bites",6,4,5,-1,-2,"Peri"
"1230",40,"6107",7,0,6,-1,NA,"Peri"
"1231",40,"9696",4,1,5,1,-3,"Peri"
"1232",40,"andrea",8,6,5,-3,-2,"Peri"
"1233",40,"Asad",2,2,2,0,0,"Peri"
"1234",40,"ASDF1234",5,7,5,0,2,"Peri"
"1235",40,"Astrid",5,7,4,-1,2,"Peri"
"1236",40,"Bøllemis",7,7,7,0,0,"Peri"
"1237",40,"Carmesin",4,2,5,1,-2,"Peri"
"1238",40,"Christian Jacobsen",6,6,6,0,0,"Peri"
"1239",40,"GOAT",6,3,4,-2,-3,"Peri"
"1240",40,"Grandmasterflash",3,3,5,2,0,"Peri"
"1241",40,"havegang7",7,5,8,1,-2,"Peri"
"1242",40,"hejhejhund",5,3,5,0,-2,"Peri"
"1243",40,"JakobBjerreKnudsen",7,4,7,0,-3,"Peri"
"1244",40,"Jesper",4,1,4,0,-3,"Peri"
"1245",40,"Johanne",8,8,8,0,0,"Peri"
"1246",40,"Katrine",6,6,6,0,0,"Peri"
"1247",40,"lilla",6,3,4,-2,-3,"Peri"
"1248",40,"Llamaman",8,0,7,-1,NA,"Peri"
"1249",40,"minime",2,4,3,1,2,"Peri"
"1250",40,"Misterperc",4,1,4,0,-3,"Peri"
"1251",40,"Moe",7,5,7,0,-2,"Peri"
"1252",40,"Python",4,6,3,-1,2,"Peri"
"1253",40,"RBJ",3,5,5,2,2,"Peri"
"1254",40,"Rensdyrlam",6,4,6,0,-2,"Peri"
"1255",40,"rosenmeier",5,7,5,0,2,"Peri"
"1256",40,"Sarah",3,0,5,2,NA,"Peri"
"1257",40,"SKJ",8,8,8,0,0,"Peri"
"1258",40,"Slowlydying",7,5,5,-2,-2,"Peri"
"1259",40,"SOJ",6,6,6,0,0,"Peri"
"1260",40,"The cat",8,5,8,0,-3,"Peri"
"1261",40,"wtf",4,0,5,1,NA,"Peri"
"1262",41,"17",4,1,5,1,-3,"Peri"
"1263",41,"1879",5,2,4,-1,-3,"Peri"
"1264",41,"1918",6,4,5,-1,-2,"Peri"
"1265",41,"2205",5,3,2,-3,-2,"Peri"
"1266",41,"4520",5,5,4,-1,0,"Peri"
"1267",41,"45bites",6,6,8,2,0,"Peri"
"1268",41,"6107",4,7,3,-1,3,"Peri"
"1269",41,"9696",6,0,7,1,NA,"Peri"
"1270",41,"andrea",7,4,7,0,-3,"Peri"
"1271",41,"Asad",4,6,5,1,2,"Peri"
"1272",41,"ASDF1234",5,5,5,0,0,"Peri"
"1273",41,"Astrid",3,3,4,1,0,"Peri"
"1274",41,"Bøllemis",7,4,7,0,-3,"Peri"
"1275",41,"Carmesin",3,3,4,1,0,"Peri"
"1276",41,"Christian Jacobsen",5,7,6,1,2,"Peri"
"1277",41,"GOAT",3,1,6,3,-2,"Peri"
"1278",41,"Grandmasterflash",7,4,5,-2,-3,"Peri"
"1279",41,"havegang7",6,8,7,1,2,"Peri"
"1280",41,"hejhejhund",5,2,3,-2,-3,"Peri"
"1281",41,"Jesper",3,0,2,-1,NA,"Peri"
"1282",41,"Johanne",6,3,6,0,-3,"Peri"
"1283",41,"Katrine",5,8,6,1,3,"Peri"
"1284",41,"lilla",8,5,7,-1,-3,"Peri"
"1285",41,"Llamaman",7,4,7,0,-3,"Peri"
"1286",41,"minime",5,2,3,-2,-3,"Peri"
"1287",41,"Misterperc",3,6,7,4,3,"Peri"
"1288",41,"Moe",5,0,6,1,NA,"Peri"
"1289",41,"Python",3,6,2,-1,3,"Peri"
"1290",41,"RBJ",3,6,6,3,3,"Peri"
"1291",41,"Rensdyrlam",8,5,8,0,-3,"Peri"
"1292",41,"rosenmeier",6,4,4,-2,-2,"Peri"
"1293",41,"Sarah",7,7,5,-2,0,"Peri"
"1294",41,"SKJ",4,4,6,2,0,"Peri"
"1295",41,"Slowlydying",5,3,7,2,-2,"Peri"
"1296",41,"SOJ",6,0,3,-3,NA,"Peri"
"1297",41,"The cat",8,6,8,0,-2,"Peri"
"1298",41,"wtf",3,0,4,1,NA,"Peri"
"1299",42,"17",6,6,3,-3,0,"Peri"
"1300",42,"1879",2,2,2,0,0,"Peri"
"1301",42,"1918",4,6,5,1,2,"Peri"
"1302",42,"2205",2,4,3,1,2,"Peri"
"1303",42,"4520",4,4,3,-1,0,"Peri"
"1304",42,"45bites",5,2,4,-1,-3,"Peri"
"1305",42,"6107",3,5,3,0,2,"Peri"
"1306",42,"9696",5,5,3,-2,0,"Peri"
"1307",42,"andrea",5,7,3,-2,2,"Peri"
"1308",42,"Asad",5,7,3,-2,2,"Peri"
"1309",42,"ASDF1234",3,0,3,0,NA,"Peri"
"1310",42,"Astrid",2,2,3,1,0,"Peri"
"1311",42,"Bøllemis",7,4,7,0,-3,"Peri"
"1312",42,"Carmesin",6,3,4,-2,-3,"Peri"
"1313",42,"Christian Jacobsen",1,0,3,2,NA,"Peri"
"1314",42,"GOAT",5,3,2,-3,-2,"Peri"
"1315",42,"Grandmasterflash",2,4,3,1,2,"Peri"
"1316",42,"havegang7",6,3,6,0,-3,"Peri"
"1317",42,"hejhejhund",5,2,4,-1,-3,"Peri"
"1318",42,"Jesper",4,7,1,-3,3,"Peri"
"1319",42,"Johanne",5,5,5,0,0,"Peri"
"1320",42,"Katrine",4,7,5,1,3,"Peri"
"1321",42,"lilla",3,0,4,1,NA,"Peri"
"1322",42,"Llamaman",4,6,3,-1,2,"Peri"
"1323",42,"minime",3,0,6,3,NA,"Peri"
"1324",42,"Misterperc",6,4,6,0,-2,"Peri"
"1325",42,"Moe",2,2,7,5,0,"Peri"
"1326",42,"Python",4,7,2,-2,3,"Peri"
"1327",42,"RBJ",2,4,5,3,2,"Peri"
"1328",42,"Rensdyrlam",1,1,2,1,0,"Peri"
"1329",42,"rosenmeier",2,5,2,0,3,"Peri"
"1330",42,"Sarah",3,3,3,0,0,"Peri"
"1331",42,"SKJ",4,0,4,0,NA,"Peri"
"1332",42,"Slowlydying",6,4,5,-1,-2,"Peri"
"1333",42,"SOJ",4,0,2,-2,NA,"Peri"
"1334",42,"The cat",8,5,8,0,-3,"Peri"
"1335",42,"wtf",3,3,3,0,0,"Peri"
"1336",43,"17",5,0,5,0,NA,"Peri"
"1337",43,"1879",5,3,3,-2,-2,"Peri"
"1338",43,"1918",5,0,5,0,NA,"Peri"
"1339",43,"2205",3,1,1,-2,-2,"Peri"
"1340",43,"4520",2,0,4,2,NA,"Peri"
"1341",43,"45bites",7,7,5,-2,0,"Peri"
"1342",43,"6107",5,0,4,-1,NA,"Peri"
"1343",43,"9696",6,3,6,0,-3,"Peri"
"1344",43,"andrea",5,5,7,2,0,"Peri"
"1345",43,"Asad",3,3,4,1,0,"Peri"
"1346",43,"ASDF1234",6,4,6,0,-2,"Peri"
"1347",43,"Astrid",8,6,7,-1,-2,"Peri"
"1348",43,"Bøllemis",7,7,7,0,0,"Peri"
"1349",43,"Carmesin",4,7,6,2,3,"Peri"
"1350",43,"Christian Jacobsen",3,5,6,3,2,"Peri"
"1351",43,"GOAT",6,6,5,-1,0,"Peri"
"1352",43,"Grandmasterflash",4,1,4,0,-3,"Peri"
"1353",43,"havegang7",8,8,8,0,0,"Peri"
"1354",43,"hejhejhund",3,1,4,1,-2,"Peri"
"1355",43,"JakobBjerreKnudsen",4,2,4,0,-2,"Peri"
"1356",43,"Jesper",5,3,2,-3,-2,"Peri"
"1357",43,"Johanne",6,6,6,0,0,"Peri"
"1358",43,"Katrine",5,0,5,0,NA,"Peri"
"1359",43,"lilla",7,5,8,1,-2,"Peri"
"1360",43,"Llamaman",6,3,5,-1,-3,"Peri"
"1361",43,"minime",7,5,5,-2,-2,"Peri"
"1362",43,"Misterperc",6,8,7,1,2,"Peri"
"1363",43,"Moe",7,5,7,0,-2,"Peri"
"1364",43,"Python",6,6,5,-1,0,"Peri"
"1365",43,"RBJ",3,6,7,4,3,"Peri"
"1366",43,"Rensdyrlam",5,3,5,0,-2,"Peri"
"1367",43,"rosenmeier",6,8,5,-1,2,"Peri"
"1368",43,"Sarah",4,1,3,-1,-3,"Peri"
"1369",43,"SKJ",5,8,5,0,3,"Peri"
"1370",43,"Slowlydying",8,6,8,0,-2,"Peri"
"1371",43,"SOJ",7,7,6,-1,0,"Peri"
"1372",43,"wtf",3,0,3,0,NA,"Peri"
"1373",44,"17",5,5,4,-1,0,"Peri"
"1374",44,"1879",4,4,3,-1,0,"Peri"
"1375",44,"1918",5,0,3,-2,NA,"Peri"
"1376",44,"2205",1,0,2,1,NA,"Peri"
"1377",44,"4520",6,3,3,-3,-3,"Peri"
"1378",44,"45bites",3,0,5,2,NA,"Peri"
"1379",44,"6107",2,2,3,1,0,"Peri"
"1380",44,"9696",4,7,4,0,3,"Peri"
"1381",44,"andrea",7,7,2,-5,0,"Peri"
"1382",44,"Asad",6,4,1,-5,-2,"Peri"
"1383",44,"ASDF1234",3,1,3,0,-2,"Peri"
"1384",44,"Astrid",4,0,5,1,NA,"Peri"
"1385",44,"Bøllemis",7,7,7,0,0,"Peri"
"1386",44,"Carmesin",4,4,4,0,0,"Peri"
"1387",44,"Christian Jacobsen",4,4,4,0,0,"Peri"
"1388",44,"GOAT",5,2,3,-2,-3,"Peri"
"1389",44,"Grandmasterflash",3,6,3,0,3,"Peri"
"1390",44,"havegang7",6,0,6,0,NA,"Peri"
"1391",44,"hejhejhund",5,3,4,-1,-2,"Peri"
"1392",44,"JakobBjerreKnudsen",5,7,5,0,2,"Peri"
"1393",44,"Jesper",3,3,1,-2,0,"Peri"
"1394",44,"Johanne",6,3,5,-1,-3,"Peri"
"1395",44,"Katrine",5,5,6,1,0,"Peri"
"1396",44,"lilla",5,7,4,-1,2,"Peri"
"1397",44,"Llamaman",6,8,4,-2,2,"Peri"
"1398",44,"minime",5,8,3,-2,3,"Peri"
"1399",44,"Misterperc",4,4,4,0,0,"Peri"
"1400",44,"Moe",3,6,7,4,3,"Peri"
"1401",44,"Python",2,4,2,0,2,"Peri"
"1402",44,"RBJ",2,5,5,3,3,"Peri"
"1403",44,"Rensdyrlam",6,4,4,-2,-2,"Peri"
"1404",44,"rosenmeier",4,6,3,-1,2,"Peri"
"1405",44,"Sarah",6,8,5,-1,2,"Peri"
"1406",44,"SKJ",4,2,5,1,-2,"Peri"
"1407",44,"Slowlydying",5,0,6,1,NA,"Peri"
"1408",44,"SOJ",5,7,1,-4,2,"Peri"
"1409",44,"wtf",3,6,3,0,3,"Peri"
"1410",45,"17",6,0,5,-1,NA,"Peri"
"1411",45,"1879",4,0,4,0,NA,"Peri"
"1412",45,"1918",6,4,2,-4,-2,"Peri"
"1413",45,"2205",5,0,5,0,NA,"Peri"
"1414",45,"4520",3,1,3,0,-2,"Peri"
"1415",45,"45bites",7,5,7,0,-2,"Peri"
"1416",45,"6107",4,1,5,1,-3,"Peri"
"1417",45,"9696",5,7,4,-1,2,"Peri"
"1418",45,"andrea",7,7,2,-5,0,"Peri"
"1419",45,"Asad",7,5,7,0,-2,"Peri"
"1420",45,"ASDF1234",5,2,4,-1,-3,"Peri"
"1421",45,"Astrid",4,7,6,2,3,"Peri"
"1422",45,"Bøllemis",7,7,7,0,0,"Peri"
"1423",45,"Carmesin",4,1,5,1,-3,"Peri"
"1424",45,"Christian Jacobsen",6,8,6,0,2,"Peri"
"1425",45,"GOAT",3,5,5,2,2,"Peri"
"1426",45,"Grandmasterflash",3,6,4,1,3,"Peri"
"1427",45,"havegang7",7,5,7,0,-2,"Peri"
"1428",45,"hejhejhund",6,0,6,0,NA,"Peri"
"1429",45,"JakobBjerreKnudsen",5,2,3,-2,-3,"Peri"
"1430",45,"Jesper",5,2,4,-1,-3,"Peri"
"1431",45,"Johanne",8,6,8,0,-2,"Peri"
"1432",45,"Katrine",5,0,6,1,NA,"Peri"
"1433",45,"lilla",5,3,8,3,-2,"Peri"
"1434",45,"Llamaman",4,1,4,0,-3,"Peri"
"1435",45,"minime",6,4,6,0,-2,"Peri"
"1436",45,"Misterperc",6,8,6,0,2,"Peri"
"1437",45,"Moe",6,4,8,2,-2,"Peri"
"1438",45,"Python",5,3,5,0,-2,"Peri"
"1439",45,"RBJ",3,1,5,2,-2,"Peri"
"1440",45,"Rensdyrlam",4,4,1,-3,0,"Peri"
"1441",45,"rosenmeier",5,7,6,1,2,"Peri"
"1442",45,"Sarah",3,0,3,0,NA,"Peri"
"1443",45,"SKJ",5,3,5,0,-2,"Peri"
"1444",45,"Slowlydying",7,7,8,1,0,"Peri"
"1445",45,"SOJ",6,4,5,-1,-2,"Peri"
"1446",45,"The cat",8,6,8,0,-2,"Peri"
"1447",45,"wtf",5,2,3,-2,-3,"Peri"
"1448",46,"17",1,0,6,5,NA,"Peri"
"1449",46,"1879",5,8,7,2,3,"Peri"
"1450",46,"1918",3,1,5,2,-2,"Peri"
"1451",46,"2205",1,4,2,1,3,"Peri"
"1452",46,"4520",4,7,3,-1,3,"Peri"
"1453",46,"45bites",4,2,4,0,-2,"Peri"
"1454",46,"6107",7,4,6,-1,-3,"Peri"
"1455",46,"9696",7,4,6,-1,-3,"Peri"
"1456",46,"andrea",7,0,5,-2,NA,"Peri"
"1457",46,"Asad",5,3,4,-1,-2,"Peri"
"1458",46,"ASDF1234",4,1,5,1,-3,"Peri"
"1459",46,"Astrid",8,8,6,-2,0,"Peri"
"1460",46,"Bøllemis",7,7,7,0,0,"Peri"
"1461",46,"Carmesin",4,1,4,0,-3,"Peri"
"1462",46,"Christian Jacobsen",6,4,6,0,-2,"Peri"
"1463",46,"GOAT",4,6,2,-2,2,"Peri"
"1464",46,"Grandmasterflash",4,2,3,-1,-2,"Peri"
"1465",46,"havegang7",7,4,8,1,-3,"Peri"
"1466",46,"hejhejhund",5,7,5,0,2,"Peri"
"1467",46,"JakobBjerreKnudsen",6,4,4,-2,-2,"Peri"
"1468",46,"Jesper",3,1,2,-1,-2,"Peri"
"1469",46,"Johanne",6,8,6,0,2,"Peri"
"1470",46,"Katrine",5,5,6,1,0,"Peri"
"1471",46,"lilla",8,5,8,0,-3,"Peri"
"1472",46,"Llamaman",7,7,7,0,0,"Peri"
"1473",46,"minime",3,0,5,2,NA,"Peri"
"1474",46,"Misterperc",6,4,5,-1,-2,"Peri"
"1475",46,"Moe",4,2,6,2,-2,"Peri"
"1476",46,"Python",6,0,6,0,NA,"Peri"
"1477",46,"RBJ",1,4,6,5,3,"Peri"
"1478",46,"Rensdyrlam",8,6,7,-1,-2,"Peri"
"1479",46,"rosenmeier",6,3,4,-2,-3,"Peri"
"1480",46,"Sarah",6,6,7,1,0,"Peri"
"1481",46,"SKJ",2,2,6,4,0,"Peri"
"1482",46,"Slowlydying",8,5,8,0,-3,"Peri"
"1483",46,"SOJ",4,2,3,-1,-2,"Peri"
"1484",46,"wtf",5,3,3,-2,-2,"Peri"
"1485",47,"17",6,6,7,1,0,"Peri"
"1486",47,"1879",6,8,5,-1,2,"Peri"
"1487",47,"1918",8,6,8,0,-2,"Peri"
"1488",47,"2205",8,8,7,-1,0,"Peri"
"1489",47,"4520",6,0,5,-1,NA,"Peri"
"1490",47,"45bites",8,5,8,0,-3,"Peri"
"1491",47,"6107",5,2,5,0,-3,"Peri"
"1492",47,"9696",6,3,7,1,-3,"Peri"
"1493",47,"andrea",7,5,8,1,-2,"Peri"
"1494",47,"Asad",6,4,7,1,-2,"Peri"
"1495",47,"ASDF1234",6,8,6,0,2,"Peri"
"1496",47,"Astrid",8,8,7,-1,0,"Peri"
"1497",47,"Bøllemis",7,4,7,0,-3,"Peri"
"1498",47,"Carmesin",4,7,5,1,3,"Peri"
"1499",47,"Christian Jacobsen",6,3,6,0,-3,"Peri"
"1500",47,"GOAT",5,3,7,2,-2,"Peri"
"1501",47,"Grandmasterflash",7,5,7,0,-2,"Peri"
"1502",47,"havegang7",8,5,8,0,-3,"Peri"
"1503",47,"hejhejhund",6,3,5,-1,-3,"Peri"
"1504",47,"JakobBjerreKnudsen",6,8,6,0,2,"Peri"
"1505",47,"Jesper",4,6,3,-1,2,"Peri"
"1506",47,"Johanne",7,4,8,1,-3,"Peri"
"1507",47,"Katrine",7,7,6,-1,0,"Peri"
"1508",47,"lilla",8,6,8,0,-2,"Peri"
"1509",47,"Llamaman",7,4,7,0,-3,"Peri"
"1510",47,"minime",6,8,4,-2,2,"Peri"
"1511",47,"Misterperc",8,6,7,-1,-2,"Peri"
"1512",47,"Moe",8,0,6,-2,NA,"Peri"
"1513",47,"Python",6,3,6,0,-3,"Peri"
"1514",47,"RBJ",3,3,7,4,0,"Peri"
"1515",47,"Rensdyrlam",8,0,7,-1,NA,"Peri"
"1516",47,"rosenmeier",6,8,6,0,2,"Peri"
"1517",47,"Sarah",8,5,7,-1,-3,"Peri"
"1518",47,"SKJ",6,8,6,0,2,"Peri"
"1519",47,"Slowlydying",7,4,8,1,-3,"Peri"
"1520",47,"SOJ",8,8,7,-1,0,"Peri"
"1521",47,"The cat",8,0,8,0,NA,"Peri"
"1522",47,"wtf",6,6,7,1,0,"Peri"
"1523",48,"17",6,0,4,-2,NA,"Peri"
"1524",48,"1879",4,4,3,-1,0,"Peri"
"1525",48,"1918",6,8,3,-3,2,"Peri"
"1526",48,"2205",5,8,2,-3,3,"Peri"
"1527",48,"4520",3,3,5,2,0,"Peri"
"1528",48,"45bites",3,6,5,2,3,"Peri"
"1529",48,"6107",6,3,5,-1,-3,"Peri"
"1530",48,"9696",3,6,5,2,3,"Peri"
"1531",48,"andrea",6,8,6,0,2,"Peri"
"1532",48,"Asad",1,3,1,0,2,"Peri"
"1533",48,"ASDF1234",6,0,7,1,NA,"Peri"
"1534",48,"Astrid",4,6,4,0,2,"Peri"
"1535",48,"Bøllemis",7,7,7,0,0,"Peri"
"1536",48,"Carmesin",5,8,4,-1,3,"Peri"
"1537",48,"Christian Jacobsen",6,3,7,1,-3,"Peri"
"1538",48,"GOAT",5,2,2,-3,-3,"Peri"
"1539",48,"Grandmasterflash",7,7,4,-3,0,"Peri"
"1540",48,"havegang7",6,6,7,1,0,"Peri"
"1541",48,"hejhejhund",3,3,3,0,0,"Peri"
"1542",48,"JakobBjerreKnudsen",7,5,5,-2,-2,"Peri"
"1543",48,"Jesper",3,3,3,0,0,"Peri"
"1544",48,"Johanne",7,0,7,0,NA,"Peri"
"1545",48,"Katrine",6,4,6,0,-2,"Peri"
"1546",48,"lilla",5,2,4,-1,-3,"Peri"
"1547",48,"Llamaman",4,2,7,3,-2,"Peri"
"1548",48,"minime",7,7,6,-1,0,"Peri"
"1549",48,"Misterperc",7,4,6,-1,-3,"Peri"
"1550",48,"Moe",7,4,6,-1,-3,"Peri"
"1551",48,"Python",5,7,6,1,2,"Peri"
"1552",48,"RBJ",1,1,6,5,0,"Peri"
"1553",48,"Rensdyrlam",2,5,5,3,3,"Peri"
"1554",48,"rosenmeier",3,5,4,1,2,"Peri"
"1555",48,"Sarah",1,4,5,4,3,"Peri"
"1556",48,"SKJ",7,4,6,-1,-3,"Peri"
"1557",48,"Slowlydying",7,5,8,1,-2,"Peri"
"1558",48,"SOJ",6,8,7,1,2,"Peri"
"1559",48,"wtf",5,5,4,-1,0,"Peri"
"1560",49,"17",5,7,5,0,2,"Peri"
"1561",49,"1879",3,6,3,0,3,"Peri"
"1562",49,"1918",4,4,5,1,0,"Peri"
"1563",49,"2205",7,0,8,1,NA,"Peri"
"1564",49,"4520",3,6,4,1,3,"Peri"
"1565",49,"45bites",4,0,6,2,NA,"Peri"
"1566",49,"6107",3,1,3,0,-2,"Peri"
"1567",49,"9696",3,1,2,-1,-2,"Peri"
"1568",49,"andrea",6,4,4,-2,-2,"Peri"
"1569",49,"Asad",5,2,6,1,-3,"Peri"
"1570",49,"ASDF1234",5,5,4,-1,0,"Peri"
"1571",49,"Astrid",4,1,4,0,-3,"Peri"
"1572",49,"Bøllemis",7,0,7,0,NA,"Peri"
"1573",49,"Carmesin",3,0,4,1,NA,"Peri"
"1574",49,"Christian Jacobsen",5,3,6,1,-2,"Peri"
"1575",49,"GOAT",6,3,4,-2,-3,"Peri"
"1576",49,"Grandmasterflash",5,2,4,-1,-3,"Peri"
"1577",49,"havegang7",6,4,6,0,-2,"Peri"
"1578",49,"hejhejhund",4,0,4,0,NA,"Peri"
"1579",49,"JakobBjerreKnudsen",6,6,6,0,0,"Peri"
"1580",49,"Jesper",4,1,1,-3,-3,"Peri"
"1581",49,"Johanne",7,4,6,-1,-3,"Peri"
"1582",49,"Katrine",5,8,6,1,3,"Peri"
"1583",49,"lilla",4,1,4,0,-3,"Peri"
"1584",49,"Llamaman",3,1,4,1,-2,"Peri"
"1585",49,"minime",7,5,8,1,-2,"Peri"
"1586",49,"Misterperc",4,2,6,2,-2,"Peri"
"1587",49,"Moe",2,2,7,5,0,"Peri"
"1588",49,"Python",5,8,4,-1,3,"Peri"
"1589",49,"RBJ",4,2,6,2,-2,"Peri"
"1590",49,"Rensdyrlam",3,6,2,-1,3,"Peri"
"1591",49,"rosenmeier",3,6,3,0,3,"Peri"
"1592",49,"Sarah",5,3,6,1,-2,"Peri"
"1593",49,"SKJ",5,3,5,0,-2,"Peri"
"1594",49,"Slowlydying",7,5,8,1,-2,"Peri"
"1595",49,"SOJ",6,8,2,-4,2,"Peri"
"1596",49,"The cat",8,8,8,0,0,"Peri"
"1597",49,"wtf",3,1,5,2,-2,"Peri"
"1598",5,"17",6,6,5,-1,0,"Peri"
"1599",5,"1879",5,7,5,0,2,"Peri"
"1600",5,"1918",4,0,4,0,NA,"Peri"
"1601",5,"2205",4,7,4,0,3,"Peri"
"1602",5,"4520",6,0,6,0,NA,"Peri"
"1603",5,"45bites",5,8,5,0,3,"Peri"
"1604",5,"6107",7,0,7,0,NA,"Peri"
"1605",5,"9696",6,3,5,-1,-3,"Peri"
"1606",5,"andrea",7,0,6,-1,NA,"Peri"
"1607",5,"Asad",6,4,1,-5,-2,"Peri"
"1608",5,"ASDF1234",4,0,3,-1,NA,"Peri"
"1609",5,"Astrid",5,8,5,0,3,"Peri"
"1610",5,"Bøllemis",7,4,7,0,-3,"Peri"
"1611",5,"Carmesin",4,4,4,0,0,"Peri"
"1612",5,"Christian Jacobsen",7,7,6,-1,0,"Peri"
"1613",5,"GOAT",6,0,5,-1,NA,"Peri"
"1614",5,"Grandmasterflash",8,5,6,-2,-3,"Peri"
"1615",5,"havegang7",7,7,8,1,0,"Peri"
"1616",5,"hejhejhund",8,6,8,0,-2,"Peri"
"1617",5,"JakobBjerreKnudsen",6,0,5,-1,NA,"Peri"
"1618",5,"Jesper",4,7,2,-2,3,"Peri"
"1619",5,"Johanne",7,5,7,0,-2,"Peri"
"1620",5,"Katrine",6,6,6,0,0,"Peri"
"1621",5,"lilla",8,0,6,-2,NA,"Peri"
"1622",5,"Llamaman",6,8,7,1,2,"Peri"
"1623",5,"minime",3,3,6,3,0,"Peri"
"1624",5,"Misterperc",2,4,6,4,2,"Peri"
"1625",5,"Moe",7,7,5,-2,0,"Peri"
"1626",5,"Python",7,4,5,-2,-3,"Peri"
"1627",5,"RBJ",4,2,6,2,-2,"Peri"
"1628",5,"Rensdyrlam",8,5,8,0,-3,"Peri"
"1629",5,"rosenmeier",2,4,2,0,2,"Peri"
"1630",5,"Sarah",7,5,7,0,-2,"Peri"
"1631",5,"SKJ",4,1,8,4,-3,"Peri"
"1632",5,"Slowlydying",7,4,6,-1,-3,"Peri"
"1633",5,"SOJ",6,3,3,-3,-3,"Peri"
"1634",5,"wtf",4,7,6,2,3,"Peri"
"1635",50,"17",5,5,6,1,0,"Peri"
"1636",50,"1879",6,4,7,1,-2,"Peri"
"1637",50,"1918",5,5,3,-2,0,"Peri"
"1638",50,"2205",3,6,5,2,3,"Peri"
"1639",50,"4520",5,7,2,-3,2,"Peri"
"1640",50,"45bites",3,6,4,1,3,"Peri"
"1641",50,"6107",6,3,6,0,-3,"Peri"
"1642",50,"9696",5,0,6,1,NA,"Peri"
"1643",50,"andrea",7,7,6,-1,0,"Peri"
"1644",50,"Asad",3,6,5,2,3,"Peri"
"1645",50,"ASDF1234",4,1,5,1,-3,"Peri"
"1646",50,"Astrid",4,1,3,-1,-3,"Peri"
"1647",50,"Bøllemis",7,4,7,0,-3,"Peri"
"1648",50,"Carmesin",4,2,6,2,-2,"Peri"
"1649",50,"Christian Jacobsen",7,7,6,-1,0,"Peri"
"1650",50,"GOAT",5,5,5,0,0,"Peri"
"1651",50,"Grandmasterflash",4,7,4,0,3,"Peri"
"1652",50,"havegang7",8,8,5,-3,0,"Peri"
"1653",50,"hejhejhund",6,3,5,-1,-3,"Peri"
"1654",50,"Jesper",5,5,4,-1,0,"Peri"
"1655",50,"Johanne",8,6,8,0,-2,"Peri"
"1656",50,"Katrine",5,0,6,1,NA,"Peri"
"1657",50,"lilla",7,5,6,-1,-2,"Peri"
"1658",50,"Llamaman",5,8,6,1,3,"Peri"
"1659",50,"minime",3,3,8,5,0,"Peri"
"1660",50,"Misterperc",5,5,4,-1,0,"Peri"
"1661",50,"Moe",4,7,7,3,3,"Peri"
"1662",50,"Python",5,5,5,0,0,"Peri"
"1663",50,"RBJ",2,5,6,4,3,"Peri"
"1664",50,"Rensdyrlam",1,1,8,7,0,"Peri"
"1665",50,"rosenmeier",4,6,3,-1,2,"Peri"
"1666",50,"Sarah",5,0,4,-1,NA,"Peri"
"1667",50,"SKJ",3,5,5,2,2,"Peri"
"1668",50,"Slowlydying",8,6,8,0,-2,"Peri"
"1669",50,"SOJ",7,7,6,-1,0,"Peri"
"1670",50,"wtf",3,5,3,0,2,"Peri"
"1671",51,"17",6,3,5,-1,-3,"Peri"
"1672",51,"1879",3,3,4,1,0,"Peri"
"1673",51,"1918",6,4,4,-2,-2,"Peri"
"1674",51,"2205",2,2,1,-1,0,"Peri"
"1675",51,"4520",3,3,2,-1,0,"Peri"
"1676",51,"45bites",3,5,4,1,2,"Peri"
"1677",51,"6107",6,4,6,0,-2,"Peri"
"1678",51,"9696",3,6,3,0,3,"Peri"
"1679",51,"andrea",7,7,4,-3,0,"Peri"
"1680",51,"Asad",4,1,3,-1,-3,"Peri"
"1681",51,"ASDF1234",4,6,4,0,2,"Peri"
"1682",51,"Astrid",2,4,3,1,2,"Peri"
"1683",51,"Bøllemis",7,7,7,0,0,"Peri"
"1684",51,"Carmesin",4,7,4,0,3,"Peri"
"1685",51,"Christian Jacobsen",6,0,6,0,NA,"Peri"
"1686",51,"GOAT",3,6,3,0,3,"Peri"
"1687",51,"Grandmasterflash",7,5,4,-3,-2,"Peri"
"1688",51,"havegang7",5,0,6,1,NA,"Peri"
"1689",51,"hejhejhund",5,5,4,-1,0,"Peri"
"1690",51,"JakobBjerreKnudsen",7,5,7,0,-2,"Peri"
"1691",51,"Jesper",3,6,1,-2,3,"Peri"
"1692",51,"Johanne",7,7,7,0,0,"Peri"
"1693",51,"Katrine",6,6,5,-1,0,"Peri"
"1694",51,"lilla",4,4,5,1,0,"Peri"
"1695",51,"Llamaman",6,6,7,1,0,"Peri"
"1696",51,"minime",4,1,2,-2,-3,"Peri"
"1697",51,"Misterperc",3,1,2,-1,-2,"Peri"
"1698",51,"Moe",2,5,6,4,3,"Peri"
"1699",51,"Python",3,1,4,1,-2,"Peri"
"1700",51,"RBJ",1,3,3,2,2,"Peri"
"1701",51,"Rensdyrlam",7,4,5,-2,-3,"Peri"
"1702",51,"rosenmeier",3,3,3,0,0,"Peri"
"1703",51,"Sarah",6,4,4,-2,-2,"Peri"
"1704",51,"SKJ",4,7,2,-2,3,"Peri"
"1705",51,"Slowlydying",7,4,7,0,-3,"Peri"
"1706",51,"SOJ",3,6,3,0,3,"Peri"
"1707",51,"wtf",3,0,3,0,NA,"Peri"
"1708",52,"17",6,8,4,-2,2,"Peri"
"1709",52,"1879",4,7,3,-1,3,"Peri"
"1710",52,"1918",5,2,2,-3,-3,"Peri"
"1711",52,"2205",2,2,2,0,0,"Peri"
"1712",52,"4520",5,5,3,-2,0,"Peri"
"1713",52,"45bites",6,6,2,-4,0,"Peri"
"1714",52,"6107",3,0,3,0,NA,"Peri"
"1715",52,"9696",3,1,4,1,-2,"Peri"
"1716",52,"andrea",6,4,3,-3,-2,"Peri"
"1717",52,"Asad",2,2,3,1,0,"Peri"
"1718",52,"ASDF1234",4,7,6,2,3,"Peri"
"1719",52,"Astrid",3,0,6,3,NA,"Peri"
"1720",52,"Bøllemis",7,4,7,0,-3,"Peri"
"1721",52,"Carmesin",2,5,4,2,3,"Peri"
"1722",52,"Christian Jacobsen",5,2,6,1,-3,"Peri"
"1723",52,"GOAT",2,2,3,1,0,"Peri"
"1724",52,"Grandmasterflash",3,5,4,1,2,"Peri"
"1725",52,"havegang7",5,2,6,1,-3,"Peri"
"1726",52,"hejhejhund",4,7,6,2,3,"Peri"
"1727",52,"JakobBjerreKnudsen",6,3,5,-1,-3,"Peri"
"1728",52,"Jesper",4,0,4,0,NA,"Peri"
"1729",52,"Johanne",7,0,7,0,NA,"Peri"
"1730",52,"Katrine",5,7,5,0,2,"Peri"
"1731",52,"lilla",6,8,6,0,2,"Peri"
"1732",52,"Llamaman",2,5,3,1,3,"Peri"
"1733",52,"minime",6,3,4,-2,-3,"Peri"
"1734",52,"Misterperc",6,6,3,-3,0,"Peri"
"1735",52,"Moe",3,6,7,4,3,"Peri"
"1736",52,"Python",5,8,4,-1,3,"Peri"
"1737",52,"RBJ",2,5,5,3,3,"Peri"
"1738",52,"Rensdyrlam",3,1,1,-2,-2,"Peri"
"1739",52,"rosenmeier",3,3,3,0,0,"Peri"
"1740",52,"Sarah",5,7,5,0,2,"Peri"
"1741",52,"SKJ",5,5,5,0,0,"Peri"
"1742",52,"Slowlydying",8,0,8,0,NA,"Peri"
"1743",52,"SOJ",6,3,3,-3,-3,"Peri"
"1744",52,"wtf",5,2,3,-2,-3,"Peri"
"1745",53,"17",6,3,6,0,-3,"Peri"
"1746",53,"1879",5,0,2,-3,NA,"Peri"
"1747",53,"1918",6,4,1,-5,-2,"Peri"
"1748",53,"2205",5,8,1,-4,3,"Peri"
"1749",53,"4520",3,5,2,-1,2,"Peri"
"1750",53,"45bites",5,0,6,1,NA,"Peri"
"1751",53,"6107",4,7,5,1,3,"Peri"
"1752",53,"9696",6,6,5,-1,0,"Peri"
"1753",53,"andrea",6,0,7,1,NA,"Peri"
"1754",53,"Asad",1,4,2,1,3,"Peri"
"1755",53,"ASDF1234",4,4,4,0,0,"Peri"
"1756",53,"Astrid",5,2,6,1,-3,"Peri"
"1757",53,"Bøllemis",7,4,7,0,-3,"Peri"
"1758",53,"Carmesin",6,0,4,-2,NA,"Peri"
"1759",53,"Christian Jacobsen",7,7,5,-2,0,"Peri"
"1760",53,"GOAT",4,1,3,-1,-3,"Peri"
"1761",53,"Grandmasterflash",6,3,4,-2,-3,"Peri"
"1762",53,"havegang7",7,4,7,0,-3,"Peri"
"1763",53,"hejhejhund",6,4,5,-1,-2,"Peri"
"1764",53,"JakobBjerreKnudsen",7,0,6,-1,NA,"Peri"
"1765",53,"Jesper",1,4,2,1,3,"Peri"
"1766",53,"Johanne",6,6,6,0,0,"Peri"
"1767",53,"Katrine",6,8,6,0,2,"Peri"
"1768",53,"lilla",6,4,5,-1,-2,"Peri"
"1769",53,"Llamaman",6,6,2,-4,0,"Peri"
"1770",53,"minime",3,5,4,1,2,"Peri"
"1771",53,"Misterperc",5,2,6,1,-3,"Peri"
"1772",53,"Moe",4,6,7,3,2,"Peri"
"1773",53,"Python",5,0,6,1,NA,"Peri"
"1774",53,"RBJ",3,1,7,4,-2,"Peri"
"1775",53,"Rensdyrlam",6,8,6,0,2,"Peri"
"1776",53,"rosenmeier",5,2,4,-1,-3,"Peri"
"1777",53,"Sarah",3,1,5,2,-2,"Peri"
"1778",53,"SKJ",3,1,3,0,-2,"Peri"
"1779",53,"Slowlydying",6,8,8,2,2,"Peri"
"1780",53,"SOJ",4,6,4,0,2,"Peri"
"1781",53,"wtf",4,0,5,1,NA,"Peri"
"1782",54,"17",6,6,5,-1,0,"Peri"
"1783",54,"1879",5,0,2,-3,NA,"Peri"
"1784",54,"1918",4,6,7,3,2,"Peri"
"1785",54,"2205",2,2,2,0,0,"Peri"
"1786",54,"4520",4,7,3,-1,3,"Peri"
"1787",54,"45bites",3,3,3,0,0,"Peri"
"1788",54,"6107",4,6,4,0,2,"Peri"
"1789",54,"9696",4,0,5,1,NA,"Peri"
"1790",54,"andrea",6,4,5,-1,-2,"Peri"
"1791",54,"Asad",3,6,4,1,3,"Peri"
"1792",54,"ASDF1234",3,0,5,2,NA,"Peri"
"1793",54,"Astrid",4,4,2,-2,0,"Peri"
"1794",54,"Bøllemis",7,4,7,0,-3,"Peri"
"1795",54,"Carmesin",4,6,3,-1,2,"Peri"
"1796",54,"Christian Jacobsen",5,0,4,-1,NA,"Peri"
"1797",54,"GOAT",3,5,3,0,2,"Peri"
"1798",54,"Grandmasterflash",2,4,4,2,2,"Peri"
"1799",54,"havegang7",6,8,6,0,2,"Peri"
"1800",54,"hejhejhund",5,5,6,1,0,"Peri"
"1801",54,"Jesper",3,0,1,-2,NA,"Peri"
"1802",54,"Johanne",7,7,7,0,0,"Peri"
"1803",54,"Katrine",6,0,6,0,NA,"Peri"
"1804",54,"lilla",5,7,6,1,2,"Peri"
"1805",54,"Llamaman",4,2,5,1,-2,"Peri"
"1806",54,"minime",1,4,7,6,3,"Peri"
"1807",54,"Misterperc",7,0,4,-3,NA,"Peri"
"1808",54,"Moe",6,3,6,0,-3,"Peri"
"1809",54,"Python",5,2,4,-1,-3,"Peri"
"1810",54,"RBJ",3,0,4,1,NA,"Peri"
"1811",54,"Rensdyrlam",4,4,2,-2,0,"Peri"
"1812",54,"rosenmeier",3,3,3,0,0,"Peri"
"1813",54,"Sarah",6,3,4,-2,-3,"Peri"
"1814",54,"SKJ",5,7,4,-1,2,"Peri"
"1815",54,"Slowlydying",4,2,6,2,-2,"Peri"
"1816",54,"SOJ",5,3,2,-3,-2,"Peri"
"1817",54,"The cat",8,5,8,0,-3,"Peri"
"1818",54,"wtf",2,4,3,1,2,"Peri"
"1819",55,"17",3,0,6,3,NA,"Peri"
"1820",55,"1879",3,5,3,0,2,"Peri"
"1821",55,"1918",4,4,6,2,0,"Peri"
"1822",55,"2205",6,4,3,-3,-2,"Peri"
"1823",55,"4520",4,2,3,-1,-2,"Peri"
"1824",55,"45bites",4,4,5,1,0,"Peri"
"1825",55,"6107",5,0,6,1,NA,"Peri"
"1826",55,"9696",6,0,4,-2,NA,"Peri"
"1827",55,"andrea",7,5,7,0,-2,"Peri"
"1828",55,"Asad",1,1,4,3,0,"Peri"
"1829",55,"ASDF1234",4,2,5,1,-2,"Peri"
"1830",55,"Astrid",5,7,4,-1,2,"Peri"
"1831",55,"Bøllemis",7,7,7,0,0,"Peri"
"1832",55,"Carmesin",5,5,6,1,0,"Peri"
"1833",55,"Christian Jacobsen",8,8,7,-1,0,"Peri"
"1834",55,"GOAT",5,0,4,-1,NA,"Peri"
"1835",55,"Grandmasterflash",4,4,4,0,0,"Peri"
"1836",55,"havegang7",7,7,7,0,0,"Peri"
"1837",55,"hejhejhund",5,3,7,2,-2,"Peri"
"1838",55,"JakobBjerreKnudsen",6,8,7,1,2,"Peri"
"1839",55,"Jesper",6,3,3,-3,-3,"Peri"
"1840",55,"Johanne",4,0,6,2,NA,"Peri"
"1841",55,"Katrine",6,8,7,1,2,"Peri"
"1842",55,"lilla",6,4,7,1,-2,"Peri"
"1843",55,"Llamaman",5,7,2,-3,2,"Peri"
"1844",55,"minime",7,4,4,-3,-3,"Peri"
"1845",55,"Misterperc",4,0,7,3,NA,"Peri"
"1846",55,"Moe",4,7,7,3,3,"Peri"
"1847",55,"Python",4,2,4,0,-2,"Peri"
"1848",55,"RBJ",4,2,5,1,-2,"Peri"
"1849",55,"Rensdyrlam",6,6,7,1,0,"Peri"
"1850",55,"rosenmeier",3,3,5,2,0,"Peri"
"1851",55,"Sarah",7,7,7,0,0,"Peri"
"1852",55,"SKJ",4,6,5,1,2,"Peri"
"1853",55,"Slowlydying",5,2,4,-1,-3,"Peri"
"1854",55,"SOJ",6,0,4,-2,NA,"Peri"
"1855",55,"wtf",4,1,6,2,-3,"Peri"
"1856",56,"17",6,3,5,-1,-3,"Peri"
"1857",56,"1879",6,4,7,1,-2,"Peri"
"1858",56,"1918",7,5,3,-4,-2,"Peri"
"1859",56,"2205",5,8,5,0,3,"Peri"
"1860",56,"4520",5,0,4,-1,NA,"Peri"
"1861",56,"45bites",8,6,8,0,-2,"Peri"
"1862",56,"6107",7,7,4,-3,0,"Peri"
"1863",56,"9696",4,1,5,1,-3,"Peri"
"1864",56,"andrea",7,4,8,1,-3,"Peri"
"1865",56,"Asad",6,8,6,0,2,"Peri"
"1866",56,"ASDF1234",6,3,7,1,-3,"Peri"
"1867",56,"Astrid",6,8,7,1,2,"Peri"
"1868",56,"Bøllemis",7,7,7,0,0,"Peri"
"1869",56,"Carmesin",4,2,5,1,-2,"Peri"
"1870",56,"Christian Jacobsen",7,0,7,0,NA,"Peri"
"1871",56,"GOAT",6,6,6,0,0,"Peri"
"1872",56,"Grandmasterflash",7,4,6,-1,-3,"Peri"
"1873",56,"havegang7",7,7,7,0,0,"Peri"
"1874",56,"hejhejhund",8,0,7,-1,NA,"Peri"
"1875",56,"JakobBjerreKnudsen",7,4,6,-1,-3,"Peri"
"1876",56,"Jesper",6,4,4,-2,-2,"Peri"
"1877",56,"Johanne",8,6,8,0,-2,"Peri"
"1878",56,"Katrine",7,4,7,0,-3,"Peri"
"1879",56,"lilla",7,7,8,1,0,"Peri"
"1880",56,"Llamaman",7,5,5,-2,-2,"Peri"
"1881",56,"minime",8,5,8,0,-3,"Peri"
"1882",56,"Misterperc",6,8,8,2,2,"Peri"
"1883",56,"Moe",6,6,6,0,0,"Peri"
"1884",56,"Python",5,3,6,1,-2,"Peri"
"1885",56,"RBJ",4,0,6,2,NA,"Peri"
"1886",56,"Rensdyrlam",8,8,8,0,0,"Peri"
"1887",56,"rosenmeier",8,6,7,-1,-2,"Peri"
"1888",56,"Sarah",6,4,6,0,-2,"Peri"
"1889",56,"SKJ",8,8,7,-1,0,"Peri"
"1890",56,"Slowlydying",8,6,8,0,-2,"Peri"
"1891",56,"SOJ",7,7,6,-1,0,"Peri"
"1892",56,"wtf",4,7,5,1,3,"Peri"
"1893",57,"17",6,3,5,-1,-3,"Peri"
"1894",57,"1879",4,0,4,0,NA,"Peri"
"1895",57,"1918",1,4,2,1,3,"Peri"
"1896",57,"2205",3,1,1,-2,-2,"Peri"
"1897",57,"4520",2,4,2,0,2,"Peri"
"1898",57,"45bites",5,0,3,-2,NA,"Peri"
"1899",57,"6107",4,2,5,1,-2,"Peri"
"1900",57,"9696",3,1,4,1,-2,"Peri"
"1901",57,"andrea",6,3,6,0,-3,"Peri"
"1902",57,"Asad",6,0,5,-1,NA,"Peri"
"1903",57,"ASDF1234",4,6,5,1,2,"Peri"
"1904",57,"Astrid",2,4,4,2,2,"Peri"
"1905",57,"Bøllemis",7,5,7,0,-2,"Peri"
"1906",57,"Carmesin",5,0,4,-1,NA,"Peri"
"1907",57,"Christian Jacobsen",6,3,6,0,-3,"Peri"
"1908",57,"GOAT",4,0,3,-1,NA,"Peri"
"1909",57,"Grandmasterflash",4,1,4,0,-3,"Peri"
"1910",57,"havegang7",6,8,8,2,2,"Peri"
"1911",57,"hejhejhund",6,4,6,0,-2,"Peri"
"1912",57,"JakobBjerreKnudsen",6,4,5,-1,-2,"Peri"
"1913",57,"Jesper",2,0,2,0,NA,"Peri"
"1914",57,"Johanne",6,6,5,-1,0,"Peri"
"1915",57,"Katrine",5,3,6,1,-2,"Peri"
"1916",57,"lilla",5,8,4,-1,3,"Peri"
"1917",57,"Llamaman",2,4,7,5,2,"Peri"
"1918",57,"minime",3,1,7,4,-2,"Peri"
"1919",57,"Misterperc",3,1,6,3,-2,"Peri"
"1920",57,"Moe",3,5,7,4,2,"Peri"
"1921",57,"Python",4,6,1,-3,2,"Peri"
"1922",57,"RBJ",1,1,5,4,0,"Peri"
"1923",57,"Rensdyrlam",3,5,2,-1,2,"Peri"
"1924",57,"rosenmeier",3,6,4,1,3,"Peri"
"1925",57,"Sarah",5,3,6,1,-2,"Peri"
"1926",57,"SKJ",6,8,6,0,2,"Peri"
"1927",57,"Slowlydying",4,7,6,2,3,"Peri"
"1928",57,"SOJ",5,8,5,0,3,"Peri"
"1929",57,"wtf",3,1,4,1,-2,"Peri"
"1930",58,"17",5,2,5,0,-3,"Peri"
"1931",58,"1879",3,3,2,-1,0,"Peri"
"1932",58,"1918",3,5,4,1,2,"Peri"
"1933",58,"2205",2,4,4,2,2,"Peri"
"1934",58,"4520",4,4,5,1,0,"Peri"
"1935",58,"45bites",1,4,1,0,3,"Peri"
"1936",58,"6107",4,4,3,-1,0,"Peri"
"1937",58,"9696",3,5,3,0,2,"Peri"
"1938",58,"andrea",5,5,2,-3,0,"Peri"
"1939",58,"Asad",3,3,4,1,0,"Peri"
"1940",58,"ASDF1234",4,4,3,-1,0,"Peri"
"1941",58,"Astrid",2,5,1,-1,3,"Peri"
"1942",58,"Bøllemis",7,7,7,0,0,"Peri"
"1943",58,"Carmesin",3,6,4,1,3,"Peri"
"1944",58,"Christian Jacobsen",3,0,3,0,NA,"Peri"
"1945",58,"GOAT",4,1,3,-1,-3,"Peri"
"1946",58,"Grandmasterflash",2,5,4,2,3,"Peri"
"1947",58,"havegang7",4,7,6,2,3,"Peri"
"1948",58,"hejhejhund",3,1,4,1,-2,"Peri"
"1949",58,"Jesper",3,1,4,1,-2,"Peri"
"1950",58,"Johanne",6,6,6,0,0,"Peri"
"1951",58,"Katrine",6,6,5,-1,0,"Peri"
"1952",58,"lilla",3,6,4,1,3,"Peri"
"1953",58,"Llamaman",3,5,4,1,2,"Peri"
"1954",58,"minime",2,4,5,3,2,"Peri"
"1955",58,"Misterperc",2,5,3,1,3,"Peri"
"1956",58,"Moe",3,5,8,5,2,"Peri"
"1957",58,"Python",2,5,1,-1,3,"Peri"
"1958",58,"RBJ",1,4,6,5,3,"Peri"
"1959",58,"Rensdyrlam",4,1,2,-2,-3,"Peri"
"1960",58,"rosenmeier",1,3,1,0,2,"Peri"
"1961",58,"Sarah",2,4,3,1,2,"Peri"
"1962",58,"SKJ",3,0,1,-2,NA,"Peri"
"1963",58,"Slowlydying",4,2,5,1,-2,"Peri"
"1964",58,"SOJ",2,2,1,-1,0,"Peri"
"1965",58,"The cat",8,0,8,0,NA,"Peri"
"1966",58,"wtf",2,5,3,1,3,"Peri"
"1967",59,"17",4,7,6,2,3,"Peri"
"1968",59,"1879",6,8,5,-1,2,"Peri"
"1969",59,"1918",2,2,5,3,0,"Peri"
"1970",59,"2205",8,6,5,-3,-2,"Peri"
"1971",59,"4520",5,2,6,1,-3,"Peri"
"1972",59,"45bites",5,7,6,1,2,"Peri"
"1973",59,"6107",6,4,6,0,-2,"Peri"
"1974",59,"9696",7,7,5,-2,0,"Peri"
"1975",59,"andrea",7,7,7,0,0,"Peri"
"1976",59,"Asad",7,4,7,0,-3,"Peri"
"1977",59,"ASDF1234",4,2,5,1,-2,"Peri"
"1978",59,"Astrid",5,5,6,1,0,"Peri"
"1979",59,"Bøllemis",7,5,7,0,-2,"Peri"
"1980",59,"Carmesin",4,7,5,1,3,"Peri"
"1981",59,"Christian Jacobsen",7,4,6,-1,-3,"Peri"
"1982",59,"GOAT",6,3,4,-2,-3,"Peri"
"1983",59,"Grandmasterflash",6,6,4,-2,0,"Peri"
"1984",59,"havegang7",8,6,7,-1,-2,"Peri"
"1985",59,"hejhejhund",6,0,4,-2,NA,"Peri"
"1986",59,"JakobBjerreKnudsen",6,6,6,0,0,"Peri"
"1987",59,"Jesper",6,8,5,-1,2,"Peri"
"1988",59,"Johanne",8,6,8,0,-2,"Peri"
"1989",59,"Katrine",6,4,7,1,-2,"Peri"
"1990",59,"lilla",8,0,7,-1,NA,"Peri"
"1991",59,"Llamaman",3,0,5,2,NA,"Peri"
"1992",59,"minime",7,5,5,-2,-2,"Peri"
"1993",59,"Misterperc",5,5,7,2,0,"Peri"
"1994",59,"Moe",4,6,7,3,2,"Peri"
"1995",59,"Python",4,7,5,1,3,"Peri"
"1996",59,"RBJ",4,0,7,3,NA,"Peri"
"1997",59,"Rensdyrlam",5,7,3,-2,2,"Peri"
"1998",59,"rosenmeier",7,4,6,-1,-3,"Peri"
"1999",59,"Sarah",6,8,5,-1,2,"Peri"
"2000",59,"SKJ",6,6,6,0,0,"Peri"
"2001",59,"Slowlydying",6,0,7,1,NA,"Peri"
"2002",59,"SOJ",7,4,7,0,-3,"Peri"
"2003",59,"wtf",5,7,7,2,2,"Peri"
"2004",6,"17",6,4,5,-1,-2,"Peri"
"2005",6,"1879",4,2,2,-2,-2,"Peri"
"2006",6,"1918",4,1,2,-2,-3,"Peri"
"2007",6,"2205",3,5,3,0,2,"Peri"
"2008",6,"4520",3,1,3,0,-2,"Peri"
"2009",6,"45bites",2,4,4,2,2,"Peri"
"2010",6,"6107",6,0,4,-2,NA,"Peri"
"2011",6,"9696",2,4,2,0,2,"Peri"
"2012",6,"andrea",5,8,3,-2,3,"Peri"
"2013",6,"Asad",5,8,3,-2,3,"Peri"
"2014",6,"ASDF1234",5,2,4,-1,-3,"Peri"
"2015",6,"Astrid",2,5,4,2,3,"Peri"
"2016",6,"Bøllemis",7,4,7,0,-3,"Peri"
"2017",6,"Carmesin",4,1,4,0,-3,"Peri"
"2018",6,"Christian Jacobsen",6,6,6,0,0,"Peri"
"2019",6,"GOAT",5,2,5,0,-3,"Peri"
"2020",6,"Grandmasterflash",4,1,3,-1,-3,"Peri"
"2021",6,"havegang7",5,8,5,0,3,"Peri"
"2022",6,"hejhejhund",5,0,4,-1,NA,"Peri"
"2023",6,"JakobBjerreKnudsen",5,7,5,0,2,"Peri"
"2024",6,"Jesper",4,2,2,-2,-2,"Peri"
"2025",6,"Johanne",6,3,5,-1,-3,"Peri"
"2026",6,"Katrine",5,8,6,1,3,"Peri"
"2027",6,"lilla",5,3,4,-1,-2,"Peri"
"2028",6,"Llamaman",3,0,3,0,NA,"Peri"
"2029",6,"minime",8,8,7,-1,0,"Peri"
"2030",6,"Misterperc",4,4,2,-2,0,"Peri"
"2031",6,"Moe",3,6,7,4,3,"Peri"
"2032",6,"Python",2,5,1,-1,3,"Peri"
"2033",6,"RBJ",1,0,7,6,NA,"Peri"
"2034",6,"Rensdyrlam",1,0,3,2,NA,"Peri"
"2035",6,"rosenmeier",2,4,2,0,2,"Peri"
"2036",6,"Sarah",3,5,3,0,2,"Peri"
"2037",6,"SKJ",2,5,3,1,3,"Peri"
"2038",6,"Slowlydying",3,1,4,1,-2,"Peri"
"2039",6,"SOJ",5,7,5,0,2,"Peri"
"2040",6,"The cat",8,6,8,0,-2,"Peri"
"2041",6,"wtf",2,5,2,0,3,"Peri"
"2042",60,"17",6,6,4,-2,0,"Peri"
"2043",60,"1879",4,2,6,2,-2,"Peri"
"2044",60,"1918",6,6,4,-2,0,"Peri"
"2045",60,"2205",2,2,3,1,0,"Peri"
"2046",60,"4520",4,2,4,0,-2,"Peri"
"2047",60,"45bites",4,0,5,1,NA,"Peri"
"2048",60,"6107",6,4,5,-1,-2,"Peri"
"2049",60,"9696",3,3,2,-1,0,"Peri"
"2050",60,"andrea",8,6,3,-5,-2,"Peri"
"2051",60,"Asad",7,0,5,-2,NA,"Peri"
"2052",60,"ASDF1234",6,6,5,-1,0,"Peri"
"2053",60,"Astrid",4,6,4,0,2,"Peri"
"2054",60,"Bøllemis",7,5,7,0,-2,"Peri"
"2055",60,"Carmesin",4,0,4,0,NA,"Peri"
"2056",60,"Christian Jacobsen",6,3,5,-1,-3,"Peri"
"2057",60,"GOAT",3,6,2,-1,3,"Peri"
"2058",60,"Grandmasterflash",4,0,4,0,NA,"Peri"
"2059",60,"havegang7",4,4,6,2,0,"Peri"
"2060",60,"hejhejhund",7,7,6,-1,0,"Peri"
"2061",60,"JakobBjerreKnudsen",4,2,3,-1,-2,"Peri"
"2062",60,"Jesper",4,1,2,-2,-3,"Peri"
"2063",60,"Johanne",7,0,8,1,NA,"Peri"
"2064",60,"Katrine",5,5,5,0,0,"Peri"
"2065",60,"lilla",4,4,6,2,0,"Peri"
"2066",60,"Llamaman",6,4,7,1,-2,"Peri"
"2067",60,"minime",2,4,5,3,2,"Peri"
"2068",60,"Misterperc",6,0,4,-2,NA,"Peri"
"2069",60,"Moe",6,8,7,1,2,"Peri"
"2070",60,"Python",6,8,3,-3,2,"Peri"
"2071",60,"RBJ",4,6,6,2,2,"Peri"
"2072",60,"Rensdyrlam",6,3,4,-2,-3,"Peri"
"2073",60,"rosenmeier",6,3,3,-3,-3,"Peri"
"2074",60,"Sarah",4,4,6,2,0,"Peri"
"2075",60,"SKJ",6,4,6,0,-2,"Peri"
"2076",60,"Slowlydying",8,6,8,0,-2,"Peri"
"2077",60,"SOJ",6,6,4,-2,0,"Peri"
"2078",60,"The cat",8,5,8,0,-3,"Peri"
"2079",60,"wtf",3,6,3,0,3,"Peri"
"2080",61,"17",5,8,5,0,3,"Peri"
"2081",61,"1879",2,5,5,3,3,"Peri"
"2082",61,"1918",6,0,5,-1,NA,"Peri"
"2083",61,"2205",2,5,1,-1,3,"Peri"
"2084",61,"4520",2,4,3,1,2,"Peri"
"2085",61,"45bites",6,8,3,-3,2,"Peri"
"2086",61,"6107",3,3,3,0,0,"Peri"
"2087",61,"9696",2,5,4,2,3,"Peri"
"2088",61,"andrea",6,8,3,-3,2,"Peri"
"2089",61,"Asad",7,5,6,-1,-2,"Peri"
"2090",61,"ASDF1234",4,1,4,0,-3,"Peri"
"2091",61,"Astrid",3,1,4,1,-2,"Peri"
"2092",61,"Bøllemis",7,4,7,0,-3,"Peri"
"2093",61,"Carmesin",4,6,4,0,2,"Peri"
"2094",61,"Christian Jacobsen",4,1,5,1,-3,"Peri"
"2095",61,"GOAT",2,4,2,0,2,"Peri"
"2096",61,"Grandmasterflash",5,8,5,0,3,"Peri"
"2097",61,"havegang7",7,5,6,-1,-2,"Peri"
"2098",61,"hejhejhund",6,3,5,-1,-3,"Peri"
"2099",61,"JakobBjerreKnudsen",7,7,8,1,0,"Peri"
"2100",61,"Jesper",4,2,4,0,-2,"Peri"
"2101",61,"Johanne",7,4,6,-1,-3,"Peri"
"2102",61,"Katrine",5,2,5,0,-3,"Peri"
"2103",61,"lilla",4,1,4,0,-3,"Peri"
"2104",61,"Llamaman",2,5,2,0,3,"Peri"
"2105",61,"minime",1,0,5,4,NA,"Peri"
"2106",61,"Misterperc",3,5,6,3,2,"Peri"
"2107",61,"Moe",2,4,6,4,2,"Peri"
"2108",61,"Python",4,2,1,-3,-2,"Peri"
"2109",61,"RBJ",1,3,5,4,2,"Peri"
"2110",61,"Rensdyrlam",2,5,1,-1,3,"Peri"
"2111",61,"rosenmeier",2,0,3,1,NA,"Peri"
"2112",61,"Sarah",1,4,4,3,3,"Peri"
"2113",61,"SKJ",2,2,5,3,0,"Peri"
"2114",61,"Slowlydying",6,4,6,0,-2,"Peri"
"2115",61,"SOJ",6,6,4,-2,0,"Peri"
"2116",61,"wtf",2,5,3,1,3,"Peri"
"2117",62,"17",6,4,5,-1,-2,"Peri"
"2118",62,"1879",2,5,3,1,3,"Peri"
"2119",62,"1918",3,0,4,1,NA,"Peri"
"2120",62,"2205",1,4,2,1,3,"Peri"
"2121",62,"4520",2,4,2,0,2,"Peri"
"2122",62,"45bites",4,2,3,-1,-2,"Peri"
"2123",62,"6107",2,2,2,0,0,"Peri"
"2124",62,"9696",1,1,1,0,0,"Peri"
"2125",62,"andrea",6,6,2,-4,0,"Peri"
"2126",62,"Asad",4,2,1,-3,-2,"Peri"
"2127",62,"ASDF1234",4,2,3,-1,-2,"Peri"
"2128",62,"Astrid",5,7,2,-3,2,"Peri"
"2129",62,"Bøllemis",7,5,7,0,-2,"Peri"
"2130",62,"Carmesin",4,7,3,-1,3,"Peri"
"2131",62,"Christian Jacobsen",6,6,5,-1,0,"Peri"
"2132",62,"GOAT",2,5,2,0,3,"Peri"
"2133",62,"Grandmasterflash",4,0,3,-1,NA,"Peri"
"2134",62,"havegang7",6,4,7,1,-2,"Peri"
"2135",62,"hejhejhund",3,3,4,1,0,"Peri"
"2136",62,"Jesper",4,4,2,-2,0,"Peri"
"2137",62,"Johanne",6,8,5,-1,2,"Peri"
"2138",62,"Katrine",4,2,5,1,-2,"Peri"
"2139",62,"lilla",4,2,4,0,-2,"Peri"
"2140",62,"Llamaman",2,5,4,2,3,"Peri"
"2141",62,"minime",1,3,3,2,2,"Peri"
"2142",62,"Misterperc",1,0,3,2,NA,"Peri"
"2143",62,"Moe",2,5,8,6,3,"Peri"
"2144",62,"Python",1,3,1,0,2,"Peri"
"2145",62,"RBJ",2,2,4,2,0,"Peri"
"2146",62,"Rensdyrlam",1,1,1,0,0,"Peri"
"2147",62,"rosenmeier",3,6,3,0,3,"Peri"
"2148",62,"Sarah",2,5,3,1,3,"Peri"
"2149",62,"SKJ",7,4,4,-3,-3,"Peri"
"2150",62,"Slowlydying",4,2,8,4,-2,"Peri"
"2151",62,"SOJ",6,4,4,-2,-2,"Peri"
"2152",62,"wtf",1,4,1,0,3,"Peri"
"2153",63,"17",6,4,5,-1,-2,"Peri"
"2154",63,"1879",3,0,3,0,NA,"Peri"
"2155",63,"1918",8,8,7,-1,0,"Peri"
"2156",63,"2205",8,5,8,0,-3,"Peri"
"2157",63,"4520",4,4,4,0,0,"Peri"
"2158",63,"45bites",4,4,5,1,0,"Peri"
"2159",63,"6107",7,7,7,0,0,"Peri"
"2160",63,"9696",4,4,4,0,0,"Peri"
"2161",63,"andrea",7,4,7,0,-3,"Peri"
"2162",63,"Asad",4,4,6,2,0,"Peri"
"2163",63,"ASDF1234",6,8,6,0,2,"Peri"
"2164",63,"Astrid",6,0,4,-2,NA,"Peri"
"2165",63,"Bøllemis",7,4,7,0,-3,"Peri"
"2166",63,"Carmesin",4,1,4,0,-3,"Peri"
"2167",63,"Christian Jacobsen",6,8,6,0,2,"Peri"
"2168",63,"GOAT",6,8,4,-2,2,"Peri"
"2169",63,"Grandmasterflash",8,0,7,-1,NA,"Peri"
"2170",63,"havegang7",7,4,8,1,-3,"Peri"
"2171",63,"hejhejhund",7,5,6,-1,-2,"Peri"
"2172",63,"JakobBjerreKnudsen",6,6,7,1,0,"Peri"
"2173",63,"Jesper",5,3,4,-1,-2,"Peri"
"2174",63,"Johanne",8,5,8,0,-3,"Peri"
"2175",63,"Katrine",6,4,6,0,-2,"Peri"
"2176",63,"lilla",6,8,6,0,2,"Peri"
"2177",63,"Llamaman",6,0,5,-1,NA,"Peri"
"2178",63,"minime",8,6,8,0,-2,"Peri"
"2179",63,"Misterperc",6,4,7,1,-2,"Peri"
"2180",63,"Moe",7,7,7,0,0,"Peri"
"2181",63,"Python",6,3,6,0,-3,"Peri"
"2182",63,"RBJ",5,2,6,1,-3,"Peri"
"2183",63,"Rensdyrlam",8,0,8,0,NA,"Peri"
"2184",63,"rosenmeier",6,6,2,-4,0,"Peri"
"2185",63,"Sarah",6,4,6,0,-2,"Peri"
"2186",63,"SKJ",6,4,7,1,-2,"Peri"
"2187",63,"Slowlydying",8,5,8,0,-3,"Peri"
"2188",63,"SOJ",5,0,6,1,NA,"Peri"
"2189",63,"wtf",6,4,5,-1,-2,"Peri"
"2190",64,"17",6,8,4,-2,2,"Peri"
"2191",64,"1879",4,7,6,2,3,"Peri"
"2192",64,"1918",6,3,1,-5,-3,"Peri"
"2193",64,"2205",7,5,2,-5,-2,"Peri"
"2194",64,"4520",3,5,3,0,2,"Peri"
"2195",64,"45bites",6,4,6,0,-2,"Peri"
"2196",64,"6107",4,4,5,1,0,"Peri"
"2197",64,"9696",5,7,6,1,2,"Peri"
"2198",64,"andrea",7,5,8,1,-2,"Peri"
"2199",64,"Asad",3,6,2,-1,3,"Peri"
"2200",64,"ASDF1234",6,3,6,0,-3,"Peri"
"2201",64,"Astrid",7,4,6,-1,-3,"Peri"
"2202",64,"Bøllemis",7,7,7,0,0,"Peri"
"2203",64,"Carmesin",4,1,4,0,-3,"Peri"
"2204",64,"Christian Jacobsen",6,6,6,0,0,"Peri"
"2205",64,"GOAT",6,3,4,-2,-3,"Peri"
"2206",64,"Grandmasterflash",4,2,5,1,-2,"Peri"
"2207",64,"havegang7",8,8,8,0,0,"Peri"
"2208",64,"hejhejhund",5,7,5,0,2,"Peri"
"2209",64,"Jesper",4,7,2,-2,3,"Peri"
"2210",64,"Johanne",8,5,8,0,-3,"Peri"
"2211",64,"Katrine",6,0,6,0,NA,"Peri"
"2212",64,"lilla",7,7,7,0,0,"Peri"
"2213",64,"Llamaman",4,0,6,2,NA,"Peri"
"2214",64,"minime",8,8,7,-1,0,"Peri"
"2215",64,"Misterperc",7,0,8,1,NA,"Peri"
"2216",64,"Moe",5,2,7,2,-3,"Peri"
"2217",64,"Python",6,8,5,-1,2,"Peri"
"2218",64,"RBJ",3,1,6,3,-2,"Peri"
"2219",64,"Rensdyrlam",8,5,8,0,-3,"Peri"
"2220",64,"rosenmeier",5,2,3,-2,-3,"Peri"
"2221",64,"Sarah",5,8,6,1,3,"Peri"
"2222",64,"SKJ",4,4,7,3,0,"Peri"
"2223",64,"Slowlydying",8,0,8,0,NA,"Peri"
"2224",64,"SOJ",6,3,3,-3,-3,"Peri"
"2225",64,"The cat",8,6,8,0,-2,"Peri"
"2226",64,"wtf",6,8,6,0,2,"Peri"
"2227",65,"17",4,0,5,1,NA,"Peri"
"2228",65,"1879",5,7,5,0,2,"Peri"
"2229",65,"1918",6,3,7,1,-3,"Peri"
"2230",65,"2205",5,7,5,0,2,"Peri"
"2231",65,"4520",3,1,4,1,-2,"Peri"
"2232",65,"45bites",3,6,4,1,3,"Peri"
"2233",65,"6107",7,5,6,-1,-2,"Peri"
"2234",65,"9696",3,6,4,1,3,"Peri"
"2235",65,"andrea",7,7,8,1,0,"Peri"
"2236",65,"Asad",3,6,1,-2,3,"Peri"
"2237",65,"ASDF1234",6,4,6,0,-2,"Peri"
"2238",65,"Astrid",4,1,6,2,-3,"Peri"
"2239",65,"Bøllemis",7,4,7,0,-3,"Peri"
"2240",65,"Carmesin",7,5,4,-3,-2,"Peri"
"2241",65,"Christian Jacobsen",7,5,7,0,-2,"Peri"
"2242",65,"GOAT",5,2,5,0,-3,"Peri"
"2243",65,"Grandmasterflash",5,3,5,0,-2,"Peri"
"2244",65,"havegang7",7,7,6,-1,0,"Peri"
"2245",65,"hejhejhund",8,6,6,-2,-2,"Peri"
"2246",65,"JakobBjerreKnudsen",6,0,6,0,NA,"Peri"
"2247",65,"Jesper",3,6,2,-1,3,"Peri"
"2248",65,"Johanne",7,7,6,-1,0,"Peri"
"2249",65,"Katrine",6,8,6,0,2,"Peri"
"2250",65,"lilla",6,0,7,1,NA,"Peri"
"2251",65,"Llamaman",3,5,6,3,2,"Peri"
"2252",65,"minime",4,0,3,-1,NA,"Peri"
"2253",65,"Misterperc",3,1,6,3,-2,"Peri"
"2254",65,"Moe",7,7,7,0,0,"Peri"
"2255",65,"Python",6,8,6,0,2,"Peri"
"2256",65,"RBJ",3,6,6,3,3,"Peri"
"2257",65,"Rensdyrlam",7,4,7,0,-3,"Peri"
"2258",65,"rosenmeier",5,0,6,1,NA,"Peri"
"2259",65,"Sarah",6,4,7,1,-2,"Peri"
"2260",65,"SKJ",8,5,7,-1,-3,"Peri"
"2261",65,"Slowlydying",8,5,8,0,-3,"Peri"
"2262",65,"SOJ",8,0,5,-3,NA,"Peri"
"2263",65,"wtf",4,1,5,1,-3,"Peri"
"2264",66,"17",5,5,3,-2,0,"Peri"
"2265",66,"1879",3,6,4,1,3,"Peri"
"2266",66,"1918",6,0,8,2,NA,"Peri"
"2267",66,"2205",2,5,5,3,3,"Peri"
"2268",66,"4520",5,5,2,-3,0,"Peri"
"2269",66,"45bites",4,2,4,0,-2,"Peri"
"2270",66,"6107",5,7,5,0,2,"Peri"
"2271",66,"9696",1,4,2,1,3,"Peri"
"2272",66,"andrea",5,7,3,-2,2,"Peri"
"2273",66,"Asad",2,5,1,-1,3,"Peri"
"2274",66,"ASDF1234",4,1,5,1,-3,"Peri"
"2275",66,"Astrid",3,3,1,-2,0,"Peri"
"2276",66,"Bøllemis",7,7,7,0,0,"Peri"
"2277",66,"Carmesin",2,0,3,1,NA,"Peri"
"2278",66,"Christian Jacobsen",4,2,4,0,-2,"Peri"
"2279",66,"GOAT",4,1,4,0,-3,"Peri"
"2280",66,"Grandmasterflash",3,6,3,0,3,"Peri"
"2281",66,"havegang7",7,4,8,1,-3,"Peri"
"2282",66,"hejhejhund",5,7,6,1,2,"Peri"
"2283",66,"Jesper",3,6,2,-1,3,"Peri"
"2284",66,"Johanne",7,5,6,-1,-2,"Peri"
"2285",66,"Katrine",5,3,5,0,-2,"Peri"
"2286",66,"lilla",2,0,4,2,NA,"Peri"
"2287",66,"Llamaman",2,2,3,1,0,"Peri"
"2288",66,"minime",2,5,6,4,3,"Peri"
"2289",66,"Misterperc",3,1,3,0,-2,"Peri"
"2290",66,"Moe",4,0,7,3,NA,"Peri"
"2291",66,"Python",3,1,1,-2,-2,"Peri"
"2292",66,"RBJ",2,5,6,4,3,"Peri"
"2293",66,"Rensdyrlam",7,4,1,-6,-3,"Peri"
"2294",66,"rosenmeier",2,2,4,2,0,"Peri"
"2295",66,"Sarah",3,1,1,-2,-2,"Peri"
"2296",66,"SKJ",4,1,5,1,-3,"Peri"
"2297",66,"Slowlydying",6,4,5,-1,-2,"Peri"
"2298",66,"SOJ",2,0,3,1,NA,"Peri"
"2299",66,"wtf",4,2,3,-1,-2,"Peri"
"2300",67,"17",5,7,7,2,2,"Peri"
"2301",67,"1879",5,8,4,-1,3,"Peri"
"2302",67,"1918",7,7,2,-5,0,"Peri"
"2303",67,"2205",7,5,8,1,-2,"Peri"
"2304",67,"4520",3,5,2,-1,2,"Peri"
"2305",67,"45bites",8,6,7,-1,-2,"Peri"
"2306",67,"6107",6,4,5,-1,-2,"Peri"
"2307",67,"9696",8,0,6,-2,NA,"Peri"
"2308",67,"andrea",7,4,5,-2,-3,"Peri"
"2309",67,"Asad",1,4,1,0,3,"Peri"
"2310",67,"ASDF1234",6,3,5,-1,-3,"Peri"
"2311",67,"Astrid",5,3,3,-2,-2,"Peri"
"2312",67,"Bøllemis",7,5,7,0,-2,"Peri"
"2313",67,"Carmesin",4,7,4,0,3,"Peri"
"2314",67,"Christian Jacobsen",5,3,6,1,-2,"Peri"
"2315",67,"GOAT",6,6,6,0,0,"Peri"
"2316",67,"Grandmasterflash",7,0,6,-1,NA,"Peri"
"2317",67,"havegang7",7,5,7,0,-2,"Peri"
"2318",67,"hejhejhund",4,6,5,1,2,"Peri"
"2319",67,"JakobBjerreKnudsen",6,0,6,0,NA,"Peri"
"2320",67,"Jesper",4,7,4,0,3,"Peri"
"2321",67,"Johanne",8,0,8,0,NA,"Peri"
"2322",67,"Katrine",6,3,6,0,-3,"Peri"
"2323",67,"lilla",7,7,7,0,0,"Peri"
"2324",67,"Llamaman",7,5,7,0,-2,"Peri"
"2325",67,"minime",8,8,7,-1,0,"Peri"
"2326",67,"Misterperc",5,7,7,2,2,"Peri"
"2327",67,"Moe",5,2,7,2,-3,"Peri"
"2328",67,"Python",5,3,5,0,-2,"Peri"
"2329",67,"RBJ",4,0,6,2,NA,"Peri"
"2330",67,"Rensdyrlam",8,0,8,0,NA,"Peri"
"2331",67,"rosenmeier",5,5,6,1,0,"Peri"
"2332",67,"Sarah",4,4,6,2,0,"Peri"
"2333",67,"SKJ",4,4,5,1,0,"Peri"
"2334",67,"Slowlydying",7,5,8,1,-2,"Peri"
"2335",67,"SOJ",4,4,4,0,0,"Peri"
"2336",67,"wtf",5,2,7,2,-3,"Peri"
"2337",68,"17",5,0,5,0,NA,"Peri"
"2338",68,"1879",3,1,2,-1,-2,"Peri"
"2339",68,"1918",6,6,2,-4,0,"Peri"
"2340",68,"2205",2,4,6,4,2,"Peri"
"2341",68,"4520",4,2,6,2,-2,"Peri"
"2342",68,"45bites",5,8,4,-1,3,"Peri"
"2343",68,"6107",4,1,3,-1,-3,"Peri"
"2344",68,"9696",5,7,3,-2,2,"Peri"
"2345",68,"andrea",6,4,4,-2,-2,"Peri"
"2346",68,"Asad",2,4,5,3,2,"Peri"
"2347",68,"ASDF1234",4,4,4,0,0,"Peri"
"2348",68,"Astrid",7,4,4,-3,-3,"Peri"
"2349",68,"Bøllemis",7,5,7,0,-2,"Peri"
"2350",68,"Carmesin",4,2,4,0,-2,"Peri"
"2351",68,"Christian Jacobsen",7,5,7,0,-2,"Peri"
"2352",68,"GOAT",3,3,6,3,0,"Peri"
"2353",68,"Grandmasterflash",7,0,5,-2,NA,"Peri"
"2354",68,"havegang7",6,3,6,0,-3,"Peri"
"2355",68,"hejhejhund",5,3,4,-1,-2,"Peri"
"2356",68,"JakobBjerreKnudsen",6,3,6,0,-3,"Peri"
"2357",68,"Jesper",5,7,3,-2,2,"Peri"
"2358",68,"Johanne",6,6,6,0,0,"Peri"
"2359",68,"Katrine",6,3,6,0,-3,"Peri"
"2360",68,"lilla",5,2,4,-1,-3,"Peri"
"2361",68,"Llamaman",6,4,7,1,-2,"Peri"
"2362",68,"minime",1,4,3,2,3,"Peri"
"2363",68,"Misterperc",6,3,6,0,-3,"Peri"
"2364",68,"Moe",3,3,5,2,0,"Peri"
"2365",68,"Python",3,5,5,2,2,"Peri"
"2366",68,"RBJ",2,5,6,4,3,"Peri"
"2367",68,"Rensdyrlam",6,4,6,0,-2,"Peri"
"2368",68,"rosenmeier",4,2,4,0,-2,"Peri"
"2369",68,"Sarah",6,6,5,-1,0,"Peri"
"2370",68,"SKJ",6,8,6,0,2,"Peri"
"2371",68,"Slowlydying",5,0,6,1,NA,"Peri"
"2372",68,"SOJ",3,1,3,0,-2,"Peri"
"2373",68,"The cat",8,0,8,0,NA,"Peri"
"2374",68,"wtf",3,5,4,1,2,"Peri"
"2375",69,"17",6,3,7,1,-3,"Peri"
"2376",69,"1879",2,5,3,1,3,"Peri"
"2377",69,"1918",6,3,5,-1,-3,"Peri"
"2378",69,"2205",6,3,2,-4,-3,"Peri"
"2379",69,"4520",7,7,6,-1,0,"Peri"
"2380",69,"45bites",5,8,4,-1,3,"Peri"
"2381",69,"6107",5,7,5,0,2,"Peri"
"2382",69,"9696",2,2,4,2,0,"Peri"
"2383",69,"andrea",6,6,4,-2,0,"Peri"
"2384",69,"Asad",2,4,4,2,2,"Peri"
"2385",69,"ASDF1234",6,3,6,0,-3,"Peri"
"2386",69,"Astrid",4,7,7,3,3,"Peri"
"2387",69,"Bøllemis",7,5,7,0,-2,"Peri"
"2388",69,"Carmesin",6,8,5,-1,2,"Peri"
"2389",69,"Christian Jacobsen",7,7,7,0,0,"Peri"
"2390",69,"GOAT",3,3,4,1,0,"Peri"
"2391",69,"Grandmasterflash",6,6,5,-1,0,"Peri"
"2392",69,"havegang7",6,0,8,2,NA,"Peri"
"2393",69,"hejhejhund",4,2,3,-1,-2,"Peri"
"2394",69,"JakobBjerreKnudsen",7,7,7,0,0,"Peri"
"2395",69,"Jesper",4,7,4,0,3,"Peri"
"2396",69,"Johanne",7,7,7,0,0,"Peri"
"2397",69,"Katrine",7,7,7,0,0,"Peri"
"2398",69,"lilla",6,8,7,1,2,"Peri"
"2399",69,"Llamaman",5,2,7,2,-3,"Peri"
"2400",69,"minime",6,6,6,0,0,"Peri"
"2401",69,"Misterperc",7,7,6,-1,0,"Peri"
"2402",69,"Moe",4,4,6,2,0,"Peri"
"2403",69,"Python",6,4,5,-1,-2,"Peri"
"2404",69,"RBJ",3,6,6,3,3,"Peri"
"2405",69,"Rensdyrlam",7,7,7,0,0,"Peri"
"2406",69,"rosenmeier",6,6,5,-1,0,"Peri"
"2407",69,"Sarah",6,8,3,-3,2,"Peri"
"2408",69,"SKJ",2,0,4,2,NA,"Peri"
"2409",69,"Slowlydying",8,5,8,0,-3,"Peri"
"2410",69,"SOJ",6,3,7,1,-3,"Peri"
"2411",69,"The cat",8,6,8,0,-2,"Peri"
"2412",69,"wtf",4,7,5,1,3,"Peri"
"2413",7,"17",5,8,5,0,3,"Peri"
"2414",7,"1879",3,3,3,0,0,"Peri"
"2415",7,"1918",5,7,5,0,2,"Peri"
"2416",7,"2205",4,1,1,-3,-3,"Peri"
"2417",7,"4520",3,5,3,0,2,"Peri"
"2418",7,"45bites",3,1,4,1,-2,"Peri"
"2419",7,"6107",3,3,5,2,0,"Peri"
"2420",7,"9696",6,4,3,-3,-2,"Peri"
"2421",7,"andrea",5,8,6,1,3,"Peri"
"2422",7,"Asad",5,2,2,-3,-3,"Peri"
"2423",7,"ASDF1234",6,4,6,0,-2,"Peri"
"2424",7,"Astrid",2,4,2,0,2,"Peri"
"2425",7,"Bøllemis",7,5,7,0,-2,"Peri"
"2426",7,"Carmesin",4,6,5,1,2,"Peri"
"2427",7,"Christian Jacobsen",3,6,6,3,3,"Peri"
"2428",7,"GOAT",2,2,4,2,0,"Peri"
"2429",7,"Grandmasterflash",7,4,5,-2,-3,"Peri"
"2430",7,"havegang7",6,8,6,0,2,"Peri"
"2431",7,"hejhejhund",4,6,4,0,2,"Peri"
"2432",7,"JakobBjerreKnudsen",6,6,5,-1,0,"Peri"
"2433",7,"Jesper",2,2,1,-1,0,"Peri"
"2434",7,"Johanne",5,8,6,1,3,"Peri"
"2435",7,"Katrine",5,5,6,1,0,"Peri"
"2436",7,"lilla",6,6,8,2,0,"Peri"
"2437",7,"Llamaman",7,7,3,-4,0,"Peri"
"2438",7,"minime",3,3,5,2,0,"Peri"
"2439",7,"Misterperc",4,4,5,1,0,"Peri"
"2440",7,"Moe",4,1,7,3,-3,"Peri"
"2441",7,"Python",3,5,4,1,2,"Peri"
"2442",7,"RBJ",3,5,5,2,2,"Peri"
"2443",7,"Rensdyrlam",8,5,6,-2,-3,"Peri"
"2444",7,"rosenmeier",4,1,4,0,-3,"Peri"
"2445",7,"Sarah",5,7,3,-2,2,"Peri"
"2446",7,"SKJ",5,8,5,0,3,"Peri"
"2447",7,"Slowlydying",8,6,8,0,-2,"Peri"
"2448",7,"SOJ",2,0,4,2,NA,"Peri"
"2449",7,"wtf",3,6,4,1,3,"Peri"
"2450",70,"17",5,2,4,-1,-3,"Peri"
"2451",70,"1879",4,7,5,1,3,"Peri"
"2452",70,"1918",3,0,4,1,NA,"Peri"
"2453",70,"2205",8,8,8,0,0,"Peri"
"2454",70,"4520",3,1,4,1,-2,"Peri"
"2455",70,"45bites",5,3,5,0,-2,"Peri"
"2456",70,"6107",7,7,6,-1,0,"Peri"
"2457",70,"9696",5,8,5,0,3,"Peri"
"2458",70,"andrea",8,0,4,-4,NA,"Peri"
"2459",70,"Asad",3,3,3,0,0,"Peri"
"2460",70,"ASDF1234",6,6,6,0,0,"Peri"
"2461",70,"Astrid",6,6,7,1,0,"Peri"
"2462",70,"Bøllemis",7,5,7,0,-2,"Peri"
"2463",70,"Carmesin",4,6,4,0,2,"Peri"
"2464",70,"Christian Jacobsen",6,3,6,0,-3,"Peri"
"2465",70,"GOAT",4,1,7,3,-3,"Peri"
"2466",70,"Grandmasterflash",4,0,5,1,NA,"Peri"
"2467",70,"havegang7",8,8,8,0,0,"Peri"
"2468",70,"hejhejhund",4,2,4,0,-2,"Peri"
"2469",70,"JakobBjerreKnudsen",6,3,6,0,-3,"Peri"
"2470",70,"Jesper",3,3,2,-1,0,"Peri"
"2471",70,"Johanne",8,8,6,-2,0,"Peri"
"2472",70,"Katrine",6,8,6,0,2,"Peri"
"2473",70,"lilla",6,6,6,0,0,"Peri"
"2474",70,"Llamaman",4,0,6,2,NA,"Peri"
"2475",70,"minime",5,7,3,-2,2,"Peri"
"2476",70,"Misterperc",6,4,6,0,-2,"Peri"
"2477",70,"Moe",3,3,7,4,0,"Peri"
"2478",70,"Python",5,0,5,0,NA,"Peri"
"2479",70,"RBJ",3,3,7,4,0,"Peri"
"2480",70,"Rensdyrlam",8,6,8,0,-2,"Peri"
"2481",70,"rosenmeier",4,6,2,-2,2,"Peri"
"2482",70,"Sarah",7,0,4,-3,NA,"Peri"
"2483",70,"SKJ",7,7,7,0,0,"Peri"
"2484",70,"Slowlydying",6,4,5,-1,-2,"Peri"
"2485",70,"SOJ",3,6,3,0,3,"Peri"
"2486",70,"The cat",8,5,8,0,-3,"Peri"
"2487",70,"wtf",3,5,4,1,2,"Peri"
"2488",71,"17",7,0,6,-1,NA,"Peri"
"2489",71,"1879",4,4,3,-1,0,"Peri"
"2490",71,"1918",6,8,8,2,2,"Peri"
"2491",71,"2205",6,6,7,1,0,"Peri"
"2492",71,"4520",2,2,3,1,0,"Peri"
"2493",71,"45bites",6,3,7,1,-3,"Peri"
"2494",71,"6107",5,5,5,0,0,"Peri"
"2495",71,"9696",5,5,5,0,0,"Peri"
"2496",71,"andrea",7,7,7,0,0,"Peri"
"2497",71,"Asad",7,0,5,-2,NA,"Peri"
"2498",71,"ASDF1234",6,6,6,0,0,"Peri"
"2499",71,"Astrid",4,0,4,0,NA,"Peri"
"2500",71,"Bøllemis",7,0,7,0,NA,"Peri"
"2501",71,"Carmesin",6,4,5,-1,-2,"Peri"
"2502",71,"Christian Jacobsen",4,4,6,2,0,"Peri"
"2503",71,"GOAT",3,3,4,1,0,"Peri"
"2504",71,"Grandmasterflash",6,8,4,-2,2,"Peri"
"2505",71,"havegang7",6,4,8,2,-2,"Peri"
"2506",71,"hejhejhund",4,0,5,1,NA,"Peri"
"2507",71,"JakobBjerreKnudsen",6,3,6,0,-3,"Peri"
"2508",71,"Jesper",3,6,2,-1,3,"Peri"
"2509",71,"Johanne",7,5,8,1,-2,"Peri"
"2510",71,"Katrine",6,3,7,1,-3,"Peri"
"2511",71,"lilla",7,5,8,1,-2,"Peri"
"2512",71,"Llamaman",6,3,6,0,-3,"Peri"
"2513",71,"minime",8,5,2,-6,-3,"Peri"
"2514",71,"Misterperc",7,7,7,0,0,"Peri"
"2515",71,"Moe",6,3,7,1,-3,"Peri"
"2516",71,"Python",1,4,5,4,3,"Peri"
"2517",71,"RBJ",2,5,7,5,3,"Peri"
"2518",71,"Rensdyrlam",8,8,8,0,0,"Peri"
"2519",71,"rosenmeier",7,5,6,-1,-2,"Peri"
"2520",71,"Sarah",5,7,3,-2,2,"Peri"
"2521",71,"SKJ",5,3,5,0,-2,"Peri"
"2522",71,"Slowlydying",8,5,8,0,-3,"Peri"
"2523",71,"SOJ",6,4,6,0,-2,"Peri"
"2524",71,"wtf",3,5,5,2,2,"Peri"
"2525",72,"17",5,3,6,1,-2,"Peri"
"2526",72,"1879",6,8,3,-3,2,"Peri"
"2527",72,"1918",5,2,4,-1,-3,"Peri"
"2528",72,"2205",6,0,7,1,NA,"Peri"
"2529",72,"4520",4,7,4,0,3,"Peri"
"2530",72,"45bites",6,6,4,-2,0,"Peri"
"2531",72,"6107",6,8,5,-1,2,"Peri"
"2532",72,"9696",5,0,4,-1,NA,"Peri"
"2533",72,"andrea",7,5,7,0,-2,"Peri"
"2534",72,"Asad",6,0,1,-5,NA,"Peri"
"2535",72,"ASDF1234",7,0,5,-2,NA,"Peri"
"2536",72,"Astrid",4,2,3,-1,-2,"Peri"
"2537",72,"Bøllemis",7,7,7,0,0,"Peri"
"2538",72,"Carmesin",4,7,5,1,3,"Peri"
"2539",72,"Christian Jacobsen",6,4,6,0,-2,"Peri"
"2540",72,"GOAT",4,2,5,1,-2,"Peri"
"2541",72,"Grandmasterflash",4,4,5,1,0,"Peri"
"2542",72,"havegang7",6,3,6,0,-3,"Peri"
"2543",72,"hejhejhund",4,4,6,2,0,"Peri"
"2544",72,"Jesper",4,1,4,0,-3,"Peri"
"2545",72,"Johanne",7,5,6,-1,-2,"Peri"
"2546",72,"Katrine",6,3,6,0,-3,"Peri"
"2547",72,"lilla",7,0,7,0,NA,"Peri"
"2548",72,"Llamaman",5,2,6,1,-3,"Peri"
"2549",72,"minime",2,5,6,4,3,"Peri"
"2550",72,"Misterperc",4,4,4,0,0,"Peri"
"2551",72,"Moe",7,7,6,-1,0,"Peri"
"2552",72,"Python",6,0,5,-1,NA,"Peri"
"2553",72,"RBJ",3,6,6,3,3,"Peri"
"2554",72,"Rensdyrlam",5,8,5,0,3,"Peri"
"2555",72,"rosenmeier",3,3,5,2,0,"Peri"
"2556",72,"Sarah",6,4,4,-2,-2,"Peri"
"2557",72,"SKJ",5,3,6,1,-2,"Peri"
"2558",72,"Slowlydying",8,5,8,0,-3,"Peri"
"2559",72,"SOJ",7,7,5,-2,0,"Peri"
"2560",72,"wtf",3,1,3,0,-2,"Peri"
"2561",73,"17",5,7,5,0,2,"Peri"
"2562",73,"1879",4,7,1,-3,3,"Peri"
"2563",73,"1918",3,5,2,-1,2,"Peri"
"2564",73,"2205",1,1,1,0,0,"Peri"
"2565",73,"4520",2,2,2,0,0,"Peri"
"2566",73,"45bites",4,6,3,-1,2,"Peri"
"2567",73,"6107",4,4,3,-1,0,"Peri"
"2568",73,"9696",1,4,1,0,3,"Peri"
"2569",73,"andrea",5,8,3,-2,3,"Peri"
"2570",73,"Asad",3,0,3,0,NA,"Peri"
"2571",73,"ASDF1234",5,3,3,-2,-2,"Peri"
"2572",73,"Astrid",2,4,3,1,2,"Peri"
"2573",73,"Bøllemis",7,7,7,0,0,"Peri"
"2574",73,"Carmesin",1,3,3,2,2,"Peri"
"2575",73,"Christian Jacobsen",3,5,1,-2,2,"Peri"
"2576",73,"GOAT",2,4,2,0,2,"Peri"
"2577",73,"Grandmasterflash",4,2,4,0,-2,"Peri"
"2578",73,"havegang7",5,5,6,1,0,"Peri"
"2579",73,"hejhejhund",3,6,3,0,3,"Peri"
"2580",73,"JakobBjerreKnudsen",4,6,4,0,2,"Peri"
"2581",73,"Jesper",1,3,1,0,2,"Peri"
"2582",73,"Johanne",5,0,6,1,NA,"Peri"
"2583",73,"Katrine",5,3,5,0,-2,"Peri"
"2584",73,"lilla",3,3,3,0,0,"Peri"
"2585",73,"Llamaman",4,2,6,2,-2,"Peri"
"2586",73,"minime",3,1,2,-1,-2,"Peri"
"2587",73,"Misterperc",1,4,3,2,3,"Peri"
"2588",73,"Moe",2,2,1,-1,0,"Peri"
"2589",73,"Python",1,1,1,0,0,"Peri"
"2590",73,"RBJ",1,1,5,4,0,"Peri"
"2591",73,"Rensdyrlam",1,3,1,0,2,"Peri"
"2592",73,"rosenmeier",1,4,2,1,3,"Peri"
"2593",73,"Sarah",4,6,2,-2,2,"Peri"
"2594",73,"SKJ",4,0,1,-3,NA,"Peri"
"2595",73,"Slowlydying",3,1,6,3,-2,"Peri"
"2596",73,"SOJ",4,6,4,0,2,"Peri"
"2597",73,"The cat",8,0,8,0,NA,"Peri"
"2598",73,"wtf",1,1,1,0,0,"Peri"
"2599",74,"17",7,4,2,-5,-3,"Peri"
"2600",74,"1879",4,7,2,-2,3,"Peri"
"2601",74,"1918",8,8,2,-6,0,"Peri"
"2602",74,"2205",5,2,4,-1,-3,"Peri"
"2603",74,"4520",4,4,3,-1,0,"Peri"
"2604",74,"45bites",6,6,4,-2,0,"Peri"
"2605",74,"6107",6,6,4,-2,0,"Peri"
"2606",74,"9696",5,3,4,-1,-2,"Peri"
"2607",74,"andrea",7,5,3,-4,-2,"Peri"
"2608",74,"Asad",6,0,6,0,NA,"Peri"
"2609",74,"ASDF1234",6,6,6,0,0,"Peri"
"2610",74,"Astrid",7,7,6,-1,0,"Peri"
"2611",74,"Bøllemis",7,5,7,0,-2,"Peri"
"2612",74,"Carmesin",2,4,5,3,2,"Peri"
"2613",74,"Christian Jacobsen",6,0,6,0,NA,"Peri"
"2614",74,"GOAT",2,4,3,1,2,"Peri"
"2615",74,"Grandmasterflash",6,3,5,-1,-3,"Peri"
"2616",74,"havegang7",8,8,8,0,0,"Peri"
"2617",74,"hejhejhund",5,7,5,0,2,"Peri"
"2618",74,"JakobBjerreKnudsen",7,5,6,-1,-2,"Peri"
"2619",74,"Jesper",4,1,2,-2,-3,"Peri"
"2620",74,"Johanne",7,4,8,1,-3,"Peri"
"2621",74,"Katrine",5,5,5,0,0,"Peri"
"2622",74,"lilla",4,6,4,0,2,"Peri"
"2623",74,"Llamaman",8,8,8,0,0,"Peri"
"2624",74,"minime",3,3,2,-1,0,"Peri"
"2625",74,"Misterperc",6,6,4,-2,0,"Peri"
"2626",74,"Moe",6,8,6,0,2,"Peri"
"2627",74,"Python",7,4,6,-1,-3,"Peri"
"2628",74,"RBJ",2,4,7,5,2,"Peri"
"2629",74,"Rensdyrlam",8,8,8,0,0,"Peri"
"2630",74,"rosenmeier",6,8,6,0,2,"Peri"
"2631",74,"Sarah",6,4,5,-1,-2,"Peri"
"2632",74,"SKJ",6,6,5,-1,0,"Peri"
"2633",74,"Slowlydying",6,8,5,-1,2,"Peri"
"2634",74,"SOJ",7,7,7,0,0,"Peri"
"2635",74,"The cat",8,6,8,0,-2,"Peri"
"2636",74,"wtf",3,5,2,-1,2,"Peri"
"2637",75,"17",4,4,4,0,0,"Peri"
"2638",75,"1879",5,2,4,-1,-3,"Peri"
"2639",75,"1918",3,1,1,-2,-2,"Peri"
"2640",75,"2205",5,2,6,1,-3,"Peri"
"2641",75,"4520",3,5,3,0,2,"Peri"
"2642",75,"45bites",7,4,7,0,-3,"Peri"
"2643",75,"6107",4,0,4,0,NA,"Peri"
"2644",75,"9696",4,4,4,0,0,"Peri"
"2645",75,"andrea",7,7,4,-3,0,"Peri"
"2646",75,"Asad",4,4,2,-2,0,"Peri"
"2647",75,"ASDF1234",4,1,4,0,-3,"Peri"
"2648",75,"Astrid",4,4,5,1,0,"Peri"
"2649",75,"Bøllemis",7,4,7,0,-3,"Peri"
"2650",75,"Carmesin",4,7,4,0,3,"Peri"
"2651",75,"Christian Jacobsen",4,6,3,-1,2,"Peri"
"2652",75,"GOAT",3,1,2,-1,-2,"Peri"
"2653",75,"Grandmasterflash",2,5,3,1,3,"Peri"
"2654",75,"havegang7",7,5,6,-1,-2,"Peri"
"2655",75,"hejhejhund",3,1,4,1,-2,"Peri"
"2656",75,"JakobBjerreKnudsen",5,8,3,-2,3,"Peri"
"2657",75,"Jesper",4,2,4,0,-2,"Peri"
"2658",75,"Johanne",7,4,6,-1,-3,"Peri"
"2659",75,"Katrine",5,8,5,0,3,"Peri"
"2660",75,"lilla",5,5,5,0,0,"Peri"
"2661",75,"Llamaman",6,6,5,-1,0,"Peri"
"2662",75,"minime",3,0,6,3,NA,"Peri"
"2663",75,"Misterperc",6,3,6,0,-3,"Peri"
"2664",75,"Moe",3,3,4,1,0,"Peri"
"2665",75,"Python",6,8,6,0,2,"Peri"
"2666",75,"RBJ",1,1,5,4,0,"Peri"
"2667",75,"Rensdyrlam",6,6,6,0,0,"Peri"
"2668",75,"rosenmeier",6,0,5,-1,NA,"Peri"
"2669",75,"Sarah",7,4,6,-1,-3,"Peri"
"2670",75,"SKJ",4,6,5,1,2,"Peri"
"2671",75,"Slowlydying",8,8,8,0,0,"Peri"
"2672",75,"SOJ",5,8,5,0,3,"Peri"
"2673",75,"wtf",2,4,2,0,2,"Peri"
"2674",76,"17",4,7,6,2,3,"Peri"
"2675",76,"1879",3,0,4,1,NA,"Peri"
"2676",76,"1918",7,5,4,-3,-2,"Peri"
"2677",76,"2205",7,7,5,-2,0,"Peri"
"2678",76,"4520",3,3,4,1,0,"Peri"
"2679",76,"45bites",8,6,8,0,-2,"Peri"
"2680",76,"6107",5,5,6,1,0,"Peri"
"2681",76,"9696",5,7,6,1,2,"Peri"
"2682",76,"andrea",8,0,8,0,NA,"Peri"
"2683",76,"Asad",4,0,4,0,NA,"Peri"
"2684",76,"ASDF1234",3,5,6,3,2,"Peri"
"2685",76,"Astrid",5,5,7,2,0,"Peri"
"2686",76,"Bøllemis",7,4,7,0,-3,"Peri"
"2687",76,"Carmesin",5,2,6,1,-3,"Peri"
"2688",76,"Christian Jacobsen",7,5,6,-1,-2,"Peri"
"2689",76,"GOAT",7,0,7,0,NA,"Peri"
"2690",76,"Grandmasterflash",3,6,5,2,3,"Peri"
"2691",76,"havegang7",7,4,8,1,-3,"Peri"
"2692",76,"hejhejhund",3,6,3,0,3,"Peri"
"2693",76,"JakobBjerreKnudsen",7,5,7,0,-2,"Peri"
"2694",76,"Jesper",3,5,3,0,2,"Peri"
"2695",76,"Johanne",7,5,8,1,-2,"Peri"
"2696",76,"Katrine",5,5,4,-1,0,"Peri"
"2697",76,"lilla",4,2,5,1,-2,"Peri"
"2698",76,"Llamaman",3,6,4,1,3,"Peri"
"2699",76,"minime",2,2,5,3,0,"Peri"
"2700",76,"Misterperc",6,4,5,-1,-2,"Peri"
"2701",76,"Moe",4,1,7,3,-3,"Peri"
"2702",76,"Python",6,6,6,0,0,"Peri"
"2703",76,"RBJ",3,1,4,1,-2,"Peri"
"2704",76,"Rensdyrlam",7,4,8,1,-3,"Peri"
"2705",76,"rosenmeier",3,0,5,2,NA,"Peri"
"2706",76,"Sarah",5,7,6,1,2,"Peri"
"2707",76,"SKJ",4,7,4,0,3,"Peri"
"2708",76,"Slowlydying",6,0,8,2,NA,"Peri"
"2709",76,"SOJ",8,6,8,0,-2,"Peri"
"2710",76,"wtf",2,4,2,0,2,"Peri"
"2711",77,"17",5,2,6,1,-3,"Peri"
"2712",77,"1879",2,4,2,0,2,"Peri"
"2713",77,"1918",6,4,3,-3,-2,"Peri"
"2714",77,"2205",7,5,7,0,-2,"Peri"
"2715",77,"4520",4,4,4,0,0,"Peri"
"2716",77,"45bites",3,0,3,0,NA,"Peri"
"2717",77,"6107",4,7,5,1,3,"Peri"
"2718",77,"9696",5,2,4,-1,-3,"Peri"
"2719",77,"andrea",7,5,4,-3,-2,"Peri"
"2720",77,"Asad",1,4,2,1,3,"Peri"
"2721",77,"ASDF1234",5,3,4,-1,-2,"Peri"
"2722",77,"Astrid",7,5,7,0,-2,"Peri"
"2723",77,"Bøllemis",7,7,7,0,0,"Peri"
"2724",77,"Carmesin",5,3,4,-1,-2,"Peri"
"2725",77,"Christian Jacobsen",6,0,7,1,NA,"Peri"
"2726",77,"GOAT",3,1,3,0,-2,"Peri"
"2727",77,"Grandmasterflash",2,5,4,2,3,"Peri"
"2728",77,"havegang7",7,0,5,-2,NA,"Peri"
"2729",77,"hejhejhund",5,7,4,-1,2,"Peri"
"2730",77,"JakobBjerreKnudsen",6,0,7,1,NA,"Peri"
"2731",77,"Jesper",4,2,2,-2,-2,"Peri"
"2732",77,"Johanne",6,6,8,2,0,"Peri"
"2733",77,"Katrine",6,6,6,0,0,"Peri"
"2734",77,"lilla",6,3,6,0,-3,"Peri"
"2735",77,"Llamaman",6,3,6,0,-3,"Peri"
"2736",77,"minime",3,0,3,0,NA,"Peri"
"2737",77,"Misterperc",6,0,6,0,NA,"Peri"
"2738",77,"Moe",3,3,6,3,0,"Peri"
"2739",77,"Python",6,8,5,-1,2,"Peri"
"2740",77,"RBJ",1,1,6,5,0,"Peri"
"2741",77,"Rensdyrlam",3,6,3,0,3,"Peri"
"2742",77,"rosenmeier",5,7,3,-2,2,"Peri"
"2743",77,"Sarah",4,0,7,3,NA,"Peri"
"2744",77,"SKJ",6,6,7,1,0,"Peri"
"2745",77,"Slowlydying",8,6,8,0,-2,"Peri"
"2746",77,"SOJ",6,6,3,-3,0,"Peri"
"2747",77,"wtf",4,6,5,1,2,"Peri"
"2748",78,"17",4,7,4,0,3,"Peri"
"2749",78,"1879",4,2,2,-2,-2,"Peri"
"2750",78,"1918",3,5,5,2,2,"Peri"
"2751",78,"2205",4,1,3,-1,-3,"Peri"
"2752",78,"4520",2,0,3,1,NA,"Peri"
"2753",78,"45bites",3,0,2,-1,NA,"Peri"
"2754",78,"6107",4,7,3,-1,3,"Peri"
"2755",78,"9696",2,5,3,1,3,"Peri"
"2756",78,"andrea",5,3,3,-2,-2,"Peri"
"2757",78,"Asad",2,2,1,-1,0,"Peri"
"2758",78,"ASDF1234",3,0,3,0,NA,"Peri"
"2759",78,"Astrid",3,3,3,0,0,"Peri"
"2760",78,"Bøllemis",7,5,7,0,-2,"Peri"
"2761",78,"Carmesin",4,6,5,1,2,"Peri"
"2762",78,"Christian Jacobsen",1,3,1,0,2,"Peri"
"2763",78,"GOAT",5,2,4,-1,-3,"Peri"
"2764",78,"Grandmasterflash",4,2,4,0,-2,"Peri"
"2765",78,"havegang7",6,8,5,-1,2,"Peri"
"2766",78,"hejhejhund",4,7,3,-1,3,"Peri"
"2767",78,"JakobBjerreKnudsen",4,2,5,1,-2,"Peri"
"2768",78,"Jesper",2,2,1,-1,0,"Peri"
"2769",78,"Johanne",7,4,7,0,-3,"Peri"
"2770",78,"Katrine",5,3,6,1,-2,"Peri"
"2771",78,"lilla",2,5,3,1,3,"Peri"
"2772",78,"Llamaman",3,3,5,2,0,"Peri"
"2773",78,"minime",4,4,3,-1,0,"Peri"
"2774",78,"Misterperc",3,5,2,-1,2,"Peri"
"2775",78,"Moe",4,7,4,0,3,"Peri"
"2776",78,"Python",3,6,2,-1,3,"Peri"
"2777",78,"RBJ",3,6,5,2,3,"Peri"
"2778",78,"Rensdyrlam",1,0,1,0,NA,"Peri"
"2779",78,"rosenmeier",2,4,2,0,2,"Peri"
"2780",78,"Sarah",1,1,4,3,0,"Peri"
"2781",78,"SKJ",3,3,1,-2,0,"Peri"
"2782",78,"Slowlydying",6,6,7,1,0,"Peri"
"2783",78,"SOJ",4,7,3,-1,3,"Peri"
"2784",78,"The cat",8,5,8,0,-3,"Peri"
"2785",78,"wtf",2,2,2,0,0,"Peri"
"2786",79,"17",6,4,4,-2,-2,"Peri"
"2787",79,"1879",5,0,3,-2,NA,"Peri"
"2788",79,"1918",7,7,6,-1,0,"Peri"
"2789",79,"2205",7,4,8,1,-3,"Peri"
"2790",79,"4520",5,7,5,0,2,"Peri"
"2791",79,"45bites",4,1,7,3,-3,"Peri"
"2792",79,"6107",7,4,5,-2,-3,"Peri"
"2793",79,"9696",7,4,6,-1,-3,"Peri"
"2794",79,"andrea",7,0,7,0,NA,"Peri"
"2795",79,"Asad",6,3,4,-2,-3,"Peri"
"2796",79,"ASDF1234",5,8,6,1,3,"Peri"
"2797",79,"Astrid",7,7,5,-2,0,"Peri"
"2798",79,"Bøllemis",7,5,7,0,-2,"Peri"
"2799",79,"Carmesin",4,2,6,2,-2,"Peri"
"2800",79,"Christian Jacobsen",6,0,6,0,NA,"Peri"
"2801",79,"GOAT",7,7,7,0,0,"Peri"
"2802",79,"Grandmasterflash",7,7,7,0,0,"Peri"
"2803",79,"havegang7",7,0,7,0,NA,"Peri"
"2804",79,"hejhejhund",5,8,4,-1,3,"Peri"
"2805",79,"JakobBjerreKnudsen",7,5,7,0,-2,"Peri"
"2806",79,"Jesper",6,3,2,-4,-3,"Peri"
"2807",79,"Johanne",7,4,7,0,-3,"Peri"
"2808",79,"Katrine",6,8,6,0,2,"Peri"
"2809",79,"lilla",6,3,5,-1,-3,"Peri"
"2810",79,"Llamaman",5,3,7,2,-2,"Peri"
"2811",79,"minime",7,0,2,-5,NA,"Peri"
"2812",79,"Misterperc",6,3,5,-1,-3,"Peri"
"2813",79,"Moe",5,8,7,2,3,"Peri"
"2814",79,"Python",6,8,6,0,2,"Peri"
"2815",79,"RBJ",2,5,6,4,3,"Peri"
"2816",79,"Rensdyrlam",8,5,8,0,-3,"Peri"
"2817",79,"rosenmeier",3,0,6,3,NA,"Peri"
"2818",79,"Sarah",7,7,6,-1,0,"Peri"
"2819",79,"SKJ",7,0,7,0,NA,"Peri"
"2820",79,"Slowlydying",8,8,8,0,0,"Peri"
"2821",79,"SOJ",8,8,7,-1,0,"Peri"
"2822",79,"wtf",4,2,5,1,-2,"Peri"
"2823",8,"17",4,4,5,1,0,"Peri"
"2824",8,"1879",4,2,3,-1,-2,"Peri"
"2825",8,"1918",6,6,1,-5,0,"Peri"
"2826",8,"2205",4,1,4,0,-3,"Peri"
"2827",8,"4520",3,6,4,1,3,"Peri"
"2828",8,"45bites",3,5,5,2,2,"Peri"
"2829",8,"6107",4,7,4,0,3,"Peri"
"2830",8,"9696",4,1,3,-1,-3,"Peri"
"2831",8,"andrea",6,6,2,-4,0,"Peri"
"2832",8,"Asad",5,2,3,-2,-3,"Peri"
"2833",8,"ASDF1234",4,7,4,0,3,"Peri"
"2834",8,"Astrid",5,7,6,1,2,"Peri"
"2835",8,"Bøllemis",7,7,7,0,0,"Peri"
"2836",8,"Carmesin",1,0,4,3,NA,"Peri"
"2837",8,"Christian Jacobsen",5,3,4,-1,-2,"Peri"
"2838",8,"GOAT",3,6,3,0,3,"Peri"
"2839",8,"Grandmasterflash",3,3,5,2,0,"Peri"
"2840",8,"havegang7",5,5,5,0,0,"Peri"
"2841",8,"hejhejhund",5,3,5,0,-2,"Peri"
"2842",8,"JakobBjerreKnudsen",4,1,4,0,-3,"Peri"
"2843",8,"Jesper",3,3,5,2,0,"Peri"
"2844",8,"Johanne",7,5,6,-1,-2,"Peri"
"2845",8,"Katrine",5,3,6,1,-2,"Peri"
"2846",8,"lilla",5,2,3,-2,-3,"Peri"
"2847",8,"Llamaman",4,6,4,0,2,"Peri"
"2848",8,"minime",6,6,6,0,0,"Peri"
"2849",8,"Misterperc",7,4,6,-1,-3,"Peri"
"2850",8,"Moe",3,1,6,3,-2,"Peri"
"2851",8,"Python",6,0,4,-2,NA,"Peri"
"2852",8,"RBJ",3,1,5,2,-2,"Peri"
"2853",8,"Rensdyrlam",1,3,6,5,2,"Peri"
"2854",8,"rosenmeier",4,4,3,-1,0,"Peri"
"2855",8,"Sarah",6,6,5,-1,0,"Peri"
"2856",8,"SKJ",6,0,5,-1,NA,"Peri"
"2857",8,"Slowlydying",8,5,8,0,-3,"Peri"
"2858",8,"SOJ",2,5,1,-1,3,"Peri"
"2859",8,"wtf",4,7,6,2,3,"Peri"
"2860",80,"17",4,6,4,0,2,"Peri"
"2861",80,"1879",6,3,4,-2,-3,"Peri"
"2862",80,"1918",4,2,2,-2,-2,"Peri"
"2863",80,"2205",4,2,2,-2,-2,"Peri"
"2864",80,"4520",3,5,5,2,2,"Peri"
"2865",80,"45bites",3,6,4,1,3,"Peri"
"2866",80,"6107",6,3,5,-1,-3,"Peri"
"2867",80,"9696",4,6,2,-2,2,"Peri"
"2868",80,"andrea",5,3,4,-1,-2,"Peri"
"2869",80,"Asad",2,2,5,3,0,"Peri"
"2870",80,"ASDF1234",4,7,4,0,3,"Peri"
"2871",80,"Astrid",5,3,7,2,-2,"Peri"
"2872",80,"Bøllemis",7,4,7,0,-3,"Peri"
"2873",80,"Carmesin",4,1,3,-1,-3,"Peri"
"2874",80,"Christian Jacobsen",6,8,4,-2,2,"Peri"
"2875",80,"GOAT",5,8,2,-3,3,"Peri"
"2876",80,"Grandmasterflash",6,8,5,-1,2,"Peri"
"2877",80,"havegang7",6,6,8,2,0,"Peri"
"2878",80,"hejhejhund",6,8,4,-2,2,"Peri"
"2879",80,"JakobBjerreKnudsen",5,2,4,-1,-3,"Peri"
"2880",80,"Jesper",4,0,3,-1,NA,"Peri"
"2881",80,"Johanne",7,7,7,0,0,"Peri"
"2882",80,"Katrine",5,8,5,0,3,"Peri"
"2883",80,"lilla",6,4,4,-2,-2,"Peri"
"2884",80,"Llamaman",4,2,3,-1,-2,"Peri"
"2885",80,"minime",3,3,5,2,0,"Peri"
"2886",80,"Misterperc",3,3,6,3,0,"Peri"
"2887",80,"Moe",8,0,6,-2,NA,"Peri"
"2888",80,"Python",2,4,2,0,2,"Peri"
"2889",80,"RBJ",4,4,6,2,0,"Peri"
"2890",80,"Rensdyrlam",2,0,6,4,NA,"Peri"
"2891",80,"rosenmeier",5,7,4,-1,2,"Peri"
"2892",80,"Sarah",5,8,5,0,3,"Peri"
"2893",80,"SKJ",5,0,6,1,NA,"Peri"
"2894",80,"Slowlydying",5,7,3,-2,2,"Peri"
"2895",80,"SOJ",4,2,3,-1,-2,"Peri"
"2896",80,"wtf",3,5,5,2,2,"Peri"
"2897",81,"17",1,1,4,3,0,"Peri"
"2898",81,"1879",3,6,3,0,3,"Peri"
"2899",81,"1918",6,8,3,-3,2,"Peri"
"2900",81,"2205",3,0,1,-2,NA,"Peri"
"2901",81,"4520",4,6,6,2,2,"Peri"
"2902",81,"45bites",6,3,5,-1,-3,"Peri"
"2903",81,"6107",4,1,4,0,-3,"Peri"
"2904",81,"9696",6,0,4,-2,NA,"Peri"
"2905",81,"andrea",6,3,7,1,-3,"Peri"
"2906",81,"Asad",2,4,1,-1,2,"Peri"
"2907",81,"ASDF1234",5,8,6,1,3,"Peri"
"2908",81,"Astrid",4,1,5,1,-3,"Peri"
"2909",81,"Bøllemis",7,5,7,0,-2,"Peri"
"2910",81,"Carmesin",4,0,4,0,NA,"Peri"
"2911",81,"Christian Jacobsen",5,8,4,-1,3,"Peri"
"2912",81,"GOAT",6,8,4,-2,2,"Peri"
"2913",81,"Grandmasterflash",6,6,3,-3,0,"Peri"
"2914",81,"havegang7",7,5,7,0,-2,"Peri"
"2915",81,"hejhejhund",7,5,4,-3,-2,"Peri"
"2916",81,"JakobBjerreKnudsen",7,0,6,-1,NA,"Peri"
"2917",81,"Jesper",3,6,1,-2,3,"Peri"
"2918",81,"Johanne",6,3,6,0,-3,"Peri"
"2919",81,"Katrine",5,7,6,1,2,"Peri"
"2920",81,"lilla",6,6,6,0,0,"Peri"
"2921",81,"Llamaman",6,6,3,-3,0,"Peri"
"2922",81,"minime",6,3,5,-1,-3,"Peri"
"2923",81,"Misterperc",3,5,3,0,2,"Peri"
"2924",81,"Moe",5,2,7,2,-3,"Peri"
"2925",81,"Python",5,3,3,-2,-2,"Peri"
"2926",81,"RBJ",3,3,6,3,0,"Peri"
"2927",81,"Rensdyrlam",7,0,3,-4,NA,"Peri"
"2928",81,"rosenmeier",3,5,4,1,2,"Peri"
"2929",81,"Sarah",3,0,4,1,NA,"Peri"
"2930",81,"SKJ",3,1,4,1,-2,"Peri"
"2931",81,"Slowlydying",6,6,6,0,0,"Peri"
"2932",81,"SOJ",6,4,4,-2,-2,"Peri"
"2933",81,"The cat",8,0,8,0,NA,"Peri"
"2934",81,"wtf",2,4,3,1,2,"Peri"
"2935",9,"17",5,3,4,-1,-2,"Peri"
"2936",9,"1879",3,1,5,2,-2,"Peri"
"2937",9,"1918",5,8,7,2,3,"Peri"
"2938",9,"2205",5,5,4,-1,0,"Peri"
"2939",9,"4520",4,1,4,0,-3,"Peri"
"2940",9,"45bites",5,3,5,0,-2,"Peri"
"2941",9,"6107",4,0,4,0,NA,"Peri"
"2942",9,"9696",2,4,3,1,2,"Peri"
"2943",9,"andrea",6,8,7,1,2,"Peri"
"2944",9,"Asad",3,5,5,2,2,"Peri"
"2945",9,"ASDF1234",5,2,5,0,-3,"Peri"
"2946",9,"Astrid",3,3,5,2,0,"Peri"
"2947",9,"Bøllemis",7,5,7,0,-2,"Peri"
"2948",9,"Carmesin",5,2,5,0,-3,"Peri"
"2949",9,"Christian Jacobsen",5,5,2,-3,0,"Peri"
"2950",9,"GOAT",3,1,4,1,-2,"Peri"
"2951",9,"Grandmasterflash",4,0,5,1,NA,"Peri"
"2952",9,"havegang7",6,3,6,0,-3,"Peri"
"2953",9,"hejhejhund",7,7,5,-2,0,"Peri"
"2954",9,"JakobBjerreKnudsen",6,3,5,-1,-3,"Peri"
"2955",9,"Jesper",4,4,4,0,0,"Peri"
"2956",9,"Johanne",7,4,6,-1,-3,"Peri"
"2957",9,"Katrine",5,5,5,0,0,"Peri"
"2958",9,"lilla",6,6,4,-2,0,"Peri"
"2959",9,"Llamaman",5,3,3,-2,-2,"Peri"
"2960",9,"minime",5,3,7,2,-2,"Peri"
"2961",9,"Misterperc",3,5,3,0,2,"Peri"
"2962",9,"Moe",3,6,6,3,3,"Peri"
"2963",9,"Python",3,0,2,-1,NA,"Peri"
"2964",9,"RBJ",1,1,5,4,0,"Peri"
"2965",9,"Rensdyrlam",4,0,3,-1,NA,"Peri"
"2966",9,"rosenmeier",3,3,3,0,0,"Peri"
"2967",9,"Sarah",2,5,3,1,3,"Peri"
"2968",9,"SKJ",3,3,6,3,0,"Peri"
"2969",9,"Slowlydying",7,5,8,1,-2,"Peri"
"2970",9,"SOJ",1,3,4,3,2,"Peri"
"2971",9,"wtf",4,1,3,-1,-3,"Peri"
